,Date,location_key,new_hospitalized_patients,cumulative_hospitalized_patients,current_hospitalized_patients,new_intensive_care_patients,cumulative_intensive_care_patients,current_intensive_care_patients,current_ventilator_patients,Date,location_key,new_persons_vaccinated,cumulative_persons_vaccinated,new_persons_fully_vaccinated,cumulative_persons_fully_vaccinated,new_vaccine_doses_administered,cumulative_vaccine_doses_administered
0,2021-01-27,AR,579,248829,0,111,40216,0,0,2021-01-27,AR,9720,5428856,18189,4640500,27909,10069356
1,2021-01-27,AR,579,248829,0,111,40216,0,0,2021-01-27,AR,4955,5249159,10174,4244260,15129,9493419
2,2021-01-27,AR,579,248829,0,111,40216,0,0,2021-01-27,AR,33435,4859247,13441,3713918,46876,8573165
3,2021-01-27,AR,579,248829,0,111,40216,0,0,2021-01-27,AR,7475,4237360,32112,3153091,39587,7390451
4,2021-01-27,AR,579,248829,0,111,40216,0,0,2021-01-27,AR,11027,4014991,54610,2044934,65637,6059925
5,2021-01-27,AR,579,248829,0,111,40216,0,0,2021-01-27,AR,29746,3529582,33243,926087,62989,4455669
6,2021-01-27,AR,579,248829,0,111,40216,0,0,2021-01-27,AR,20902,2346737,2904,584528,23806,2931265
7,2021-01-27,AR,579,248829,0,111,40216,0,0,2021-01-27,AR,11545,1326469,10742,380910,22287,1707379
8,2021-01-27,AR,579,248829,0,111,40216,0,0,2021-01-27,AR,21410,988431,740,129174,22150,1117605
9,2021-01-27,AR,579,248829,0,111,40216,0,0,2021-01-27,AR,8064,435557,454,96544,8518,532101
10,2021-01-27,AR,579,248829,0,111,40216,0,0,2021-01-27,AR,2054,132951,280,42911,2334,175862
11,2021-01-27,AR,579,248829,0,111,40216,0,0,2021-01-27,AR,557,39246,853,7896,1410,47142
12,2021-01-27,AR,385,262759,0,75,42974,0,0,2021-01-27,AR,9720,5428856,18189,4640500,27909,10069356
13,2021-01-27,AR,385,262759,0,75,42974,0,0,2021-01-27,AR,4955,5249159,10174,4244260,15129,9493419
14,2021-01-27,AR,385,262759,0,75,42974,0,0,2021-01-27,AR,33435,4859247,13441,3713918,46876,8573165
15,2021-01-27,AR,385,262759,0,75,42974,0,0,2021-01-27,AR,7475,4237360,32112,3153091,39587,7390451
16,2021-01-27,AR,385,262759,0,75,42974,0,0,2021-01-27,AR,11027,4014991,54610,2044934,65637,6059925
17,2021-01-27,AR,385,262759,0,75,42974,0,0,2021-01-27,AR,29746,3529582,33243,926087,62989,4455669
18,2021-01-27,AR,385,262759,0,75,42974,0,0,2021-01-27,AR,20902,2346737,2904,584528,23806,2931265
19,2021-01-27,AR,385,262759,0,75,42974,0,0,2021-01-27,AR,11545,1326469,10742,380910,22287,1707379
20,2021-01-27,AR,385,262759,0,75,42974,0,0,2021-01-27,AR,21410,988431,740,129174,22150,1117605
21,2021-01-27,AR,385,262759,0,75,42974,0,0,2021-01-27,AR,8064,435557,454,96544,8518,532101
22,2021-01-27,AR,385,262759,0,75,42974,0,0,2021-01-27,AR,2054,132951,280,42911,2334,175862
23,2021-01-27,AR,385,262759,0,75,42974,0,0,2021-01-27,AR,557,39246,853,7896,1410,47142
24,2021-01-27,AR,454,276082,0,94,45567,0,0,2021-01-27,AR,9720,5428856,18189,4640500,27909,10069356
25,2021-01-27,AR,454,276082,0,94,45567,0,0,2021-01-27,AR,4955,5249159,10174,4244260,15129,9493419
26,2021-01-27,AR,454,276082,0,94,45567,0,0,2021-01-27,AR,33435,4859247,13441,3713918,46876,8573165
27,2021-01-27,AR,454,276082,0,94,45567,0,0,2021-01-27,AR,7475,4237360,32112,3153091,39587,7390451
28,2021-01-27,AR,454,276082,0,94,45567,0,0,2021-01-27,AR,11027,4014991,54610,2044934,65637,6059925
29,2021-01-27,AR,454,276082,0,94,45567,0,0,2021-01-27,AR,29746,3529582,33243,926087,62989,4455669
30,2021-01-27,AR,454,276082,0,94,45567,0,0,2021-01-27,AR,20902,2346737,2904,584528,23806,2931265
31,2021-01-27,AR,454,276082,0,94,45567,0,0,2021-01-27,AR,11545,1326469,10742,380910,22287,1707379
32,2021-01-27,AR,454,276082,0,94,45567,0,0,2021-01-27,AR,21410,988431,740,129174,22150,1117605
33,2021-01-27,AR,454,276082,0,94,45567,0,0,2021-01-27,AR,8064,435557,454,96544,8518,532101
34,2021-01-27,AR,454,276082,0,94,45567,0,0,2021-01-27,AR,2054,132951,280,42911,2334,175862
35,2021-01-27,AR,454,276082,0,94,45567,0,0,2021-01-27,AR,557,39246,853,7896,1410,47142
36,2021-01-27,AR,922,300954,0,208,50763,0,0,2021-01-27,AR,9720,5428856,18189,4640500,27909,10069356
37,2021-01-27,AR,922,300954,0,208,50763,0,0,2021-01-27,AR,4955,5249159,10174,4244260,15129,9493419
38,2021-01-27,AR,922,300954,0,208,50763,0,0,2021-01-27,AR,33435,4859247,13441,3713918,46876,8573165
39,2021-01-27,AR,922,300954,0,208,50763,0,0,2021-01-27,AR,7475,4237360,32112,3153091,39587,7390451
40,2021-01-27,AR,922,300954,0,208,50763,0,0,2021-01-27,AR,11027,4014991,54610,2044934,65637,6059925
41,2021-01-27,AR,922,300954,0,208,50763,0,0,2021-01-27,AR,29746,3529582,33243,926087,62989,4455669
42,2021-01-27,AR,922,300954,0,208,50763,0,0,2021-01-27,AR,20902,2346737,2904,584528,23806,2931265
43,2021-01-27,AR,922,300954,0,208,50763,0,0,2021-01-27,AR,11545,1326469,10742,380910,22287,1707379
44,2021-01-27,AR,922,300954,0,208,50763,0,0,2021-01-27,AR,21410,988431,740,129174,22150,1117605
45,2021-01-27,AR,922,300954,0,208,50763,0,0,2021-01-27,AR,8064,435557,454,96544,8518,532101
46,2021-01-27,AR,922,300954,0,208,50763,0,0,2021-01-27,AR,2054,132951,280,42911,2334,175862
47,2021-01-27,AR,922,300954,0,208,50763,0,0,2021-01-27,AR,557,39246,853,7896,1410,47142
48,2021-01-27,AR,1314,331445,0,245,57482,0,0,2021-01-27,AR,9720,5428856,18189,4640500,27909,10069356
49,2021-01-27,AR,1314,331445,0,245,57482,0,0,2021-01-27,AR,4955,5249159,10174,4244260,15129,9493419
50,2021-01-27,AR,1314,331445,0,245,57482,0,0,2021-01-27,AR,33435,4859247,13441,3713918,46876,8573165
51,2021-01-27,AR,1314,331445,0,245,57482,0,0,2021-01-27,AR,7475,4237360,32112,3153091,39587,7390451
52,2021-01-27,AR,1314,331445,0,245,57482,0,0,2021-01-27,AR,11027,4014991,54610,2044934,65637,6059925
53,2021-01-27,AR,1314,331445,0,245,57482,0,0,2021-01-27,AR,29746,3529582,33243,926087,62989,4455669
54,2021-01-27,AR,1314,331445,0,245,57482,0,0,2021-01-27,AR,20902,2346737,2904,584528,23806,2931265
55,2021-01-27,AR,1314,331445,0,245,57482,0,0,2021-01-27,AR,11545,1326469,10742,380910,22287,1707379
56,2021-01-27,AR,1314,331445,0,245,57482,0,0,2021-01-27,AR,21410,988431,740,129174,22150,1117605
57,2021-01-27,AR,1314,331445,0,245,57482,0,0,2021-01-27,AR,8064,435557,454,96544,8518,532101
58,2021-01-27,AR,1314,331445,0,245,57482,0,0,2021-01-27,AR,2054,132951,280,42911,2334,175862
59,2021-01-27,AR,1314,331445,0,245,57482,0,0,2021-01-27,AR,557,39246,853,7896,1410,47142
60,2021-01-27,AR,644,362920,0,149,64494,0,0,2021-01-27,AR,9720,5428856,18189,4640500,27909,10069356
61,2021-01-27,AR,644,362920,0,149,64494,0,0,2021-01-27,AR,4955,5249159,10174,4244260,15129,9493419
62,2021-01-27,AR,644,362920,0,149,64494,0,0,2021-01-27,AR,33435,4859247,13441,3713918,46876,8573165
63,2021-01-27,AR,644,362920,0,149,64494,0,0,2021-01-27,AR,7475,4237360,32112,3153091,39587,7390451
64,2021-01-27,AR,644,362920,0,149,64494,0,0,2021-01-27,AR,11027,4014991,54610,2044934,65637,6059925
65,2021-01-27,AR,644,362920,0,149,64494,0,0,2021-01-27,AR,29746,3529582,33243,926087,62989,4455669
66,2021-01-27,AR,644,362920,0,149,64494,0,0,2021-01-27,AR,20902,2346737,2904,584528,23806,2931265
67,2021-01-27,AR,644,362920,0,149,64494,0,0,2021-01-27,AR,11545,1326469,10742,380910,22287,1707379
68,2021-01-27,AR,644,362920,0,149,64494,0,0,2021-01-27,AR,21410,988431,740,129174,22150,1117605
69,2021-01-27,AR,644,362920,0,149,64494,0,0,2021-01-27,AR,8064,435557,454,96544,8518,532101
70,2021-01-27,AR,644,362920,0,149,64494,0,0,2021-01-27,AR,2054,132951,280,42911,2334,175862
71,2021-01-27,AR,644,362920,0,149,64494,0,0,2021-01-27,AR,557,39246,853,7896,1410,47142
72,2021-01-27,AR,652,385876,0,132,69015,0,0,2021-01-27,AR,9720,5428856,18189,4640500,27909,10069356
73,2021-01-27,AR,652,385876,0,132,69015,0,0,2021-01-27,AR,4955,5249159,10174,4244260,15129,9493419
74,2021-01-27,AR,652,385876,0,132,69015,0,0,2021-01-27,AR,33435,4859247,13441,3713918,46876,8573165
75,2021-01-27,AR,652,385876,0,132,69015,0,0,2021-01-27,AR,7475,4237360,32112,3153091,39587,7390451
76,2021-01-27,AR,652,385876,0,132,69015,0,0,2021-01-27,AR,11027,4014991,54610,2044934,65637,6059925
77,2021-01-27,AR,652,385876,0,132,69015,0,0,2021-01-27,AR,29746,3529582,33243,926087,62989,4455669
78,2021-01-27,AR,652,385876,0,132,69015,0,0,2021-01-27,AR,20902,2346737,2904,584528,23806,2931265
79,2021-01-27,AR,652,385876,0,132,69015,0,0,2021-01-27,AR,11545,1326469,10742,380910,22287,1707379
80,2021-01-27,AR,652,385876,0,132,69015,0,0,2021-01-27,AR,21410,988431,740,129174,22150,1117605
81,2021-01-27,AR,652,385876,0,132,69015,0,0,2021-01-27,AR,8064,435557,454,96544,8518,532101
82,2021-01-27,AR,652,385876,0,132,69015,0,0,2021-01-27,AR,2054,132951,280,42911,2334,175862
83,2021-01-27,AR,652,385876,0,132,69015,0,0,2021-01-27,AR,557,39246,853,7896,1410,47142
84,2021-01-27,AR,418,402979,0,67,72051,0,0,2021-01-27,AR,9720,5428856,18189,4640500,27909,10069356
85,2021-01-27,AR,418,402979,0,67,72051,0,0,2021-01-27,AR,4955,5249159,10174,4244260,15129,9493419
86,2021-01-27,AR,418,402979,0,67,72051,0,0,2021-01-27,AR,33435,4859247,13441,3713918,46876,8573165
87,2021-01-27,AR,418,402979,0,67,72051,0,0,2021-01-27,AR,7475,4237360,32112,3153091,39587,7390451
88,2021-01-27,AR,418,402979,0,67,72051,0,0,2021-01-27,AR,11027,4014991,54610,2044934,65637,6059925
89,2021-01-27,AR,418,402979,0,67,72051,0,0,2021-01-27,AR,29746,3529582,33243,926087,62989,4455669
90,2021-01-27,AR,418,402979,0,67,72051,0,0,2021-01-27,AR,20902,2346737,2904,584528,23806,2931265
91,2021-01-27,AR,418,402979,0,67,72051,0,0,2021-01-27,AR,11545,1326469,10742,380910,22287,1707379
92,2021-01-27,AR,418,402979,0,67,72051,0,0,2021-01-27,AR,21410,988431,740,129174,22150,1117605
93,2021-01-27,AR,418,402979,0,67,72051,0,0,2021-01-27,AR,8064,435557,454,96544,8518,532101
94,2021-01-27,AR,418,402979,0,67,72051,0,0,2021-01-27,AR,2054,132951,280,42911,2334,175862
95,2021-01-27,AR,418,402979,0,67,72051,0,0,2021-01-27,AR,557,39246,853,7896,1410,47142
96,2021-01-27,AR,328,413961,0,43,73541,0,0,2021-01-27,AR,9720,5428856,18189,4640500,27909,10069356
97,2021-01-27,AR,328,413961,0,43,73541,0,0,2021-01-27,AR,4955,5249159,10174,4244260,15129,9493419
98,2021-01-27,AR,328,413961,0,43,73541,0,0,2021-01-27,AR,33435,4859247,13441,3713918,46876,8573165
99,2021-01-27,AR,328,413961,0,43,73541,0,0,2021-01-27,AR,7475,4237360,32112,3153091,39587,7390451
100,2021-01-27,AR,328,413961,0,43,73541,0,0,2021-01-27,AR,11027,4014991,54610,2044934,65637,6059925
101,2021-01-27,AR,328,413961,0,43,73541,0,0,2021-01-27,AR,29746,3529582,33243,926087,62989,4455669
102,2021-01-27,AR,328,413961,0,43,73541,0,0,2021-01-27,AR,20902,2346737,2904,584528,23806,2931265
103,2021-01-27,AR,328,413961,0,43,73541,0,0,2021-01-27,AR,11545,1326469,10742,380910,22287,1707379
104,2021-01-27,AR,328,413961,0,43,73541,0,0,2021-01-27,AR,21410,988431,740,129174,22150,1117605
105,2021-01-27,AR,328,413961,0,43,73541,0,0,2021-01-27,AR,8064,435557,454,96544,8518,532101
106,2021-01-27,AR,328,413961,0,43,73541,0,0,2021-01-27,AR,2054,132951,280,42911,2334,175862
107,2021-01-27,AR,328,413961,0,43,73541,0,0,2021-01-27,AR,557,39246,853,7896,1410,47142
108,2021-01-27,AR,262,421663,0,25,74459,0,0,2021-01-27,AR,9720,5428856,18189,4640500,27909,10069356
109,2021-01-27,AR,262,421663,0,25,74459,0,0,2021-01-27,AR,4955,5249159,10174,4244260,15129,9493419
110,2021-01-27,AR,262,421663,0,25,74459,0,0,2021-01-27,AR,33435,4859247,13441,3713918,46876,8573165
111,2021-01-27,AR,262,421663,0,25,74459,0,0,2021-01-27,AR,7475,4237360,32112,3153091,39587,7390451
112,2021-01-27,AR,262,421663,0,25,74459,0,0,2021-01-27,AR,11027,4014991,54610,2044934,65637,6059925
113,2021-01-27,AR,262,421663,0,25,74459,0,0,2021-01-27,AR,29746,3529582,33243,926087,62989,4455669
114,2021-01-27,AR,262,421663,0,25,74459,0,0,2021-01-27,AR,20902,2346737,2904,584528,23806,2931265
115,2021-01-27,AR,262,421663,0,25,74459,0,0,2021-01-27,AR,11545,1326469,10742,380910,22287,1707379
116,2021-01-27,AR,262,421663,0,25,74459,0,0,2021-01-27,AR,21410,988431,740,129174,22150,1117605
117,2021-01-27,AR,262,421663,0,25,74459,0,0,2021-01-27,AR,8064,435557,454,96544,8518,532101
118,2021-01-27,AR,262,421663,0,25,74459,0,0,2021-01-27,AR,2054,132951,280,42911,2334,175862
119,2021-01-27,AR,262,421663,0,25,74459,0,0,2021-01-27,AR,557,39246,853,7896,1410,47142
120,2021-01-27,AR,198,428687,0,22,75338,0,0,2021-01-27,AR,9720,5428856,18189,4640500,27909,10069356
121,2021-01-27,AR,198,428687,0,22,75338,0,0,2021-01-27,AR,4955,5249159,10174,4244260,15129,9493419
122,2021-01-27,AR,198,428687,0,22,75338,0,0,2021-01-27,AR,33435,4859247,13441,3713918,46876,8573165
123,2021-01-27,AR,198,428687,0,22,75338,0,0,2021-01-27,AR,7475,4237360,32112,3153091,39587,7390451
124,2021-01-27,AR,198,428687,0,22,75338,0,0,2021-01-27,AR,11027,4014991,54610,2044934,65637,6059925
125,2021-01-27,AR,198,428687,0,22,75338,0,0,2021-01-27,AR,29746,3529582,33243,926087,62989,4455669
126,2021-01-27,AR,198,428687,0,22,75338,0,0,2021-01-27,AR,20902,2346737,2904,584528,23806,2931265
127,2021-01-27,AR,198,428687,0,22,75338,0,0,2021-01-27,AR,11545,1326469,10742,380910,22287,1707379
128,2021-01-27,AR,198,428687,0,22,75338,0,0,2021-01-27,AR,21410,988431,740,129174,22150,1117605
129,2021-01-27,AR,198,428687,0,22,75338,0,0,2021-01-27,AR,8064,435557,454,96544,8518,532101
130,2021-01-27,AR,198,428687,0,22,75338,0,0,2021-01-27,AR,2054,132951,280,42911,2334,175862
131,2021-01-27,AR,198,428687,0,22,75338,0,0,2021-01-27,AR,557,39246,853,7896,1410,47142
132,2021-01-27,AR,359,435445,0,60,76343,0,0,2021-01-27,AR,9720,5428856,18189,4640500,27909,10069356
133,2021-01-27,AR,359,435445,0,60,76343,0,0,2021-01-27,AR,4955,5249159,10174,4244260,15129,9493419
134,2021-01-27,AR,359,435445,0,60,76343,0,0,2021-01-27,AR,33435,4859247,13441,3713918,46876,8573165
135,2021-01-27,AR,359,435445,0,60,76343,0,0,2021-01-27,AR,7475,4237360,32112,3153091,39587,7390451
136,2021-01-27,AR,359,435445,0,60,76343,0,0,2021-01-27,AR,11027,4014991,54610,2044934,65637,6059925
137,2021-01-27,AR,359,435445,0,60,76343,0,0,2021-01-27,AR,29746,3529582,33243,926087,62989,4455669
138,2021-01-27,AR,359,435445,0,60,76343,0,0,2021-01-27,AR,20902,2346737,2904,584528,23806,2931265
139,2021-01-27,AR,359,435445,0,60,76343,0,0,2021-01-27,AR,11545,1326469,10742,380910,22287,1707379
140,2021-01-27,AR,359,435445,0,60,76343,0,0,2021-01-27,AR,21410,988431,740,129174,22150,1117605
141,2021-01-27,AR,359,435445,0,60,76343,0,0,2021-01-27,AR,8064,435557,454,96544,8518,532101
142,2021-01-27,AR,359,435445,0,60,76343,0,0,2021-01-27,AR,2054,132951,280,42911,2334,175862
143,2021-01-27,AR,359,435445,0,60,76343,0,0,2021-01-27,AR,557,39246,853,7896,1410,47142
144,2021-01-18,AR,556,243801,0,95,39171,0,0,2021-01-18,AR,3064,5389375,7814,4559723,10878,9949098
145,2021-01-18,AR,556,243801,0,95,39171,0,0,2021-01-18,AR,8941,5188863,28298,4076676,37239,9265539
146,2021-01-18,AR,556,243801,0,95,39171,0,0,2021-01-18,AR,41165,4539103,16980,3586738,58145,8125841
147,2021-01-18,AR,556,243801,0,95,39171,0,0,2021-01-18,AR,4976,4166116,28539,2912712,33515,7078828
148,2021-01-18,AR,556,243801,0,95,39171,0,0,2021-01-18,AR,14791,3905617,46561,1657862,61352,5563479
149,2021-01-18,AR,556,243801,0,95,39171,0,0,2021-01-18,AR,18693,3201838,5141,785026,23834,3986864
150,2021-01-18,AR,556,243801,0,95,39171,0,0,2021-01-18,AR,50487,2074010,6549,539661,57036,2613671
151,2021-01-18,AR,556,243801,0,95,39171,0,0,2021-01-18,AR,21878,1223125,6000,321429,27878,1544554
152,2021-01-18,AR,556,243801,0,95,39171,0,0,2021-01-18,AR,2852,825176,11,117723,2863,942899
153,2021-01-18,AR,556,243801,0,95,39171,0,0,2021-01-18,AR,13269,352011,5982,81490,19251,433501
154,2021-01-18,AR,556,243801,0,95,39171,0,0,2021-01-18,AR,7236,63150,1527,36847,8763,99997
155,2021-01-18,AR,556,243801,0,95,39171,0,0,2021-01-18,AR,1438,33324,2,11,1440,33335
156,2021-01-25,AR,622,247644,0,126,39975,0,0,2021-01-25,AR,14,5417730,20,4620229,34,10037959
157,2021-01-25,AR,622,247644,0,126,39975,0,0,2021-01-25,AR,7934,5235712,23376,4211100,31310,9446812
158,2021-01-25,AR,622,247644,0,126,39975,0,0,2021-01-25,AR,35599,4788104,16951,3678984,52550,8467088
159,2021-01-25,AR,622,247644,0,126,39975,0,0,2021-01-25,AR,4305,4228084,13224,3111016,17529,7339100
160,2021-01-25,AR,622,247644,0,126,39975,0,0,2021-01-25,AR,10450,3993690,49431,1938994,59881,5932684
161,2021-01-25,AR,622,247644,0,126,39975,0,0,2021-01-25,AR,17699,3465428,1261,869925,18960,4335353
162,2021-01-25,AR,622,247644,0,126,39975,0,0,2021-01-25,AR,42912,2292365,9505,571165,52417,2863530
163,2021-01-25,AR,622,247644,0,126,39975,0,0,2021-01-25,AR,5603,1302222,3597,361116,9200,1663338
164,2021-01-25,AR,622,247644,0,126,39975,0,0,2021-01-25,AR,6850,943069,27,127641,6877,1070710
165,2021-01-25,AR,622,247644,0,126,39975,0,0,2021-01-25,AR,13022,415081,2280,94595,15302,509676
166,2021-01-25,AR,622,247644,0,126,39975,0,0,2021-01-25,AR,9295,121099,1520,41201,10815,162300
167,2021-01-25,AR,622,247644,0,126,39975,0,0,2021-01-25,AR,1059,37972,1032,5974,2091,43946
168,2021-01-18,AR,444,258898,0,99,42242,0,0,2021-01-18,AR,3064,5389375,7814,4559723,10878,9949098
169,2021-01-18,AR,444,258898,0,99,42242,0,0,2021-01-18,AR,8941,5188863,28298,4076676,37239,9265539
170,2021-01-18,AR,444,258898,0,99,42242,0,0,2021-01-18,AR,41165,4539103,16980,3586738,58145,8125841
171,2021-01-18,AR,444,258898,0,99,42242,0,0,2021-01-18,AR,4976,4166116,28539,2912712,33515,7078828
172,2021-01-18,AR,444,258898,0,99,42242,0,0,2021-01-18,AR,14791,3905617,46561,1657862,61352,5563479
173,2021-01-18,AR,444,258898,0,99,42242,0,0,2021-01-18,AR,18693,3201838,5141,785026,23834,3986864
174,2021-01-18,AR,444,258898,0,99,42242,0,0,2021-01-18,AR,50487,2074010,6549,539661,57036,2613671
175,2021-01-18,AR,444,258898,0,99,42242,0,0,2021-01-18,AR,21878,1223125,6000,321429,27878,1544554
176,2021-01-18,AR,444,258898,0,99,42242,0,0,2021-01-18,AR,2852,825176,11,117723,2863,942899
177,2021-01-18,AR,444,258898,0,99,42242,0,0,2021-01-18,AR,13269,352011,5982,81490,19251,433501
178,2021-01-18,AR,444,258898,0,99,42242,0,0,2021-01-18,AR,7236,63150,1527,36847,8763,99997
179,2021-01-18,AR,444,258898,0,99,42242,0,0,2021-01-18,AR,1438,33324,2,11,1440,33335
180,2021-01-25,AR,475,261936,0,82,42828,0,0,2021-01-25,AR,14,5417730,20,4620229,34,10037959
181,2021-01-25,AR,475,261936,0,82,42828,0,0,2021-01-25,AR,7934,5235712,23376,4211100,31310,9446812
182,2021-01-25,AR,475,261936,0,82,42828,0,0,2021-01-25,AR,35599,4788104,16951,3678984,52550,8467088
183,2021-01-25,AR,475,261936,0,82,42828,0,0,2021-01-25,AR,4305,4228084,13224,3111016,17529,7339100
184,2021-01-25,AR,475,261936,0,82,42828,0,0,2021-01-25,AR,10450,3993690,49431,1938994,59881,5932684
185,2021-01-25,AR,475,261936,0,82,42828,0,0,2021-01-25,AR,17699,3465428,1261,869925,18960,4335353
186,2021-01-25,AR,475,261936,0,82,42828,0,0,2021-01-25,AR,42912,2292365,9505,571165,52417,2863530
187,2021-01-25,AR,475,261936,0,82,42828,0,0,2021-01-25,AR,5603,1302222,3597,361116,9200,1663338
188,2021-01-25,AR,475,261936,0,82,42828,0,0,2021-01-25,AR,6850,943069,27,127641,6877,1070710
189,2021-01-25,AR,475,261936,0,82,42828,0,0,2021-01-25,AR,13022,415081,2280,94595,15302,509676
190,2021-01-25,AR,475,261936,0,82,42828,0,0,2021-01-25,AR,9295,121099,1520,41201,10815,162300
191,2021-01-25,AR,475,261936,0,82,42828,0,0,2021-01-25,AR,1059,37972,1032,5974,2091,43946
192,2021-01-18,AR,477,271625,0,84,44656,0,0,2021-01-18,AR,3064,5389375,7814,4559723,10878,9949098
193,2021-01-18,AR,477,271625,0,84,44656,0,0,2021-01-18,AR,8941,5188863,28298,4076676,37239,9265539
194,2021-01-18,AR,477,271625,0,84,44656,0,0,2021-01-18,AR,41165,4539103,16980,3586738,58145,8125841
195,2021-01-18,AR,477,271625,0,84,44656,0,0,2021-01-18,AR,4976,4166116,28539,2912712,33515,7078828
196,2021-01-18,AR,477,271625,0,84,44656,0,0,2021-01-18,AR,14791,3905617,46561,1657862,61352,5563479
197,2021-01-18,AR,477,271625,0,84,44656,0,0,2021-01-18,AR,18693,3201838,5141,785026,23834,3986864
198,2021-01-18,AR,477,271625,0,84,44656,0,0,2021-01-18,AR,50487,2074010,6549,539661,57036,2613671
199,2021-01-18,AR,477,271625,0,84,44656,0,0,2021-01-18,AR,21878,1223125,6000,321429,27878,1544554
200,2021-01-18,AR,477,271625,0,84,44656,0,0,2021-01-18,AR,2852,825176,11,117723,2863,942899
201,2021-01-18,AR,477,271625,0,84,44656,0,0,2021-01-18,AR,13269,352011,5982,81490,19251,433501
202,2021-01-18,AR,477,271625,0,84,44656,0,0,2021-01-18,AR,7236,63150,1527,36847,8763,99997
203,2021-01-18,AR,477,271625,0,84,44656,0,0,2021-01-18,AR,1438,33324,2,11,1440,33335
204,2021-01-25,AR,597,275075,0,133,45353,0,0,2021-01-25,AR,14,5417730,20,4620229,34,10037959
205,2021-01-25,AR,597,275075,0,133,45353,0,0,2021-01-25,AR,7934,5235712,23376,4211100,31310,9446812
206,2021-01-25,AR,597,275075,0,133,45353,0,0,2021-01-25,AR,35599,4788104,16951,3678984,52550,8467088
207,2021-01-25,AR,597,275075,0,133,45353,0,0,2021-01-25,AR,4305,4228084,13224,3111016,17529,7339100
208,2021-01-25,AR,597,275075,0,133,45353,0,0,2021-01-25,AR,10450,3993690,49431,1938994,59881,5932684
209,2021-01-25,AR,597,275075,0,133,45353,0,0,2021-01-25,AR,17699,3465428,1261,869925,18960,4335353
210,2021-01-25,AR,597,275075,0,133,45353,0,0,2021-01-25,AR,42912,2292365,9505,571165,52417,2863530
211,2021-01-25,AR,597,275075,0,133,45353,0,0,2021-01-25,AR,5603,1302222,3597,361116,9200,1663338
212,2021-01-25,AR,597,275075,0,133,45353,0,0,2021-01-25,AR,6850,943069,27,127641,6877,1070710
213,2021-01-25,AR,597,275075,0,133,45353,0,0,2021-01-25,AR,13022,415081,2280,94595,15302,509676
214,2021-01-25,AR,597,275075,0,133,45353,0,0,2021-01-25,AR,9295,121099,1520,41201,10815,162300
215,2021-01-25,AR,597,275075,0,133,45353,0,0,2021-01-25,AR,1059,37972,1032,5974,2091,43946
216,2021-01-18,AR,796,292505,0,177,48938,0,0,2021-01-18,AR,3064,5389375,7814,4559723,10878,9949098
217,2021-01-18,AR,796,292505,0,177,48938,0,0,2021-01-18,AR,8941,5188863,28298,4076676,37239,9265539
218,2021-01-18,AR,796,292505,0,177,48938,0,0,2021-01-18,AR,41165,4539103,16980,3586738,58145,8125841
219,2021-01-18,AR,796,292505,0,177,48938,0,0,2021-01-18,AR,4976,4166116,28539,2912712,33515,7078828
220,2021-01-18,AR,796,292505,0,177,48938,0,0,2021-01-18,AR,14791,3905617,46561,1657862,61352,5563479
221,2021-01-18,AR,796,292505,0,177,48938,0,0,2021-01-18,AR,18693,3201838,5141,785026,23834,3986864
222,2021-01-18,AR,796,292505,0,177,48938,0,0,2021-01-18,AR,50487,2074010,6549,539661,57036,2613671
223,2021-01-18,AR,796,292505,0,177,48938,0,0,2021-01-18,AR,21878,1223125,6000,321429,27878,1544554
224,2021-01-18,AR,796,292505,0,177,48938,0,0,2021-01-18,AR,2852,825176,11,117723,2863,942899
225,2021-01-18,AR,796,292505,0,177,48938,0,0,2021-01-18,AR,13269,352011,5982,81490,19251,433501
226,2021-01-18,AR,796,292505,0,177,48938,0,0,2021-01-18,AR,7236,63150,1527,36847,8763,99997
227,2021-01-18,AR,796,292505,0,177,48938,0,0,2021-01-18,AR,1438,33324,2,11,1440,33335
228,2021-01-25,AR,759,299016,0,178,50301,0,0,2021-01-25,AR,14,5417730,20,4620229,34,10037959
229,2021-01-25,AR,759,299016,0,178,50301,0,0,2021-01-25,AR,7934,5235712,23376,4211100,31310,9446812
230,2021-01-25,AR,759,299016,0,178,50301,0,0,2021-01-25,AR,35599,4788104,16951,3678984,52550,8467088
231,2021-01-25,AR,759,299016,0,178,50301,0,0,2021-01-25,AR,4305,4228084,13224,3111016,17529,7339100
232,2021-01-25,AR,759,299016,0,178,50301,0,0,2021-01-25,AR,10450,3993690,49431,1938994,59881,5932684
233,2021-01-25,AR,759,299016,0,178,50301,0,0,2021-01-25,AR,17699,3465428,1261,869925,18960,4335353
234,2021-01-25,AR,759,299016,0,178,50301,0,0,2021-01-25,AR,42912,2292365,9505,571165,52417,2863530
235,2021-01-25,AR,759,299016,0,178,50301,0,0,2021-01-25,AR,5603,1302222,3597,361116,9200,1663338
236,2021-01-25,AR,759,299016,0,178,50301,0,0,2021-01-25,AR,6850,943069,27,127641,6877,1070710
237,2021-01-25,AR,759,299016,0,178,50301,0,0,2021-01-25,AR,13022,415081,2280,94595,15302,509676
238,2021-01-25,AR,759,299016,0,178,50301,0,0,2021-01-25,AR,9295,121099,1520,41201,10815,162300
239,2021-01-25,AR,759,299016,0,178,50301,0,0,2021-01-25,AR,1059,37972,1032,5974,2091,43946
240,2021-01-18,AR,1148,320967,0,261,55152,0,0,2021-01-18,AR,3064,5389375,7814,4559723,10878,9949098
241,2021-01-18,AR,1148,320967,0,261,55152,0,0,2021-01-18,AR,8941,5188863,28298,4076676,37239,9265539
242,2021-01-18,AR,1148,320967,0,261,55152,0,0,2021-01-18,AR,41165,4539103,16980,3586738,58145,8125841
243,2021-01-18,AR,1148,320967,0,261,55152,0,0,2021-01-18,AR,4976,4166116,28539,2912712,33515,7078828
244,2021-01-18,AR,1148,320967,0,261,55152,0,0,2021-01-18,AR,14791,3905617,46561,1657862,61352,5563479
245,2021-01-18,AR,1148,320967,0,261,55152,0,0,2021-01-18,AR,18693,3201838,5141,785026,23834,3986864
246,2021-01-18,AR,1148,320967,0,261,55152,0,0,2021-01-18,AR,50487,2074010,6549,539661,57036,2613671
247,2021-01-18,AR,1148,320967,0,261,55152,0,0,2021-01-18,AR,21878,1223125,6000,321429,27878,1544554
248,2021-01-18,AR,1148,320967,0,261,55152,0,0,2021-01-18,AR,2852,825176,11,117723,2863,942899
249,2021-01-18,AR,1148,320967,0,261,55152,0,0,2021-01-18,AR,13269,352011,5982,81490,19251,433501
250,2021-01-18,AR,1148,320967,0,261,55152,0,0,2021-01-18,AR,7236,63150,1527,36847,8763,99997
251,2021-01-18,AR,1148,320967,0,261,55152,0,0,2021-01-18,AR,1438,33324,2,11,1440,33335
252,2021-01-25,AR,1163,328799,0,284,56985,0,0,2021-01-25,AR,14,5417730,20,4620229,34,10037959
253,2021-01-25,AR,1163,328799,0,284,56985,0,0,2021-01-25,AR,7934,5235712,23376,4211100,31310,9446812
254,2021-01-25,AR,1163,328799,0,284,56985,0,0,2021-01-25,AR,35599,4788104,16951,3678984,52550,8467088
255,2021-01-25,AR,1163,328799,0,284,56985,0,0,2021-01-25,AR,4305,4228084,13224,3111016,17529,7339100
256,2021-01-25,AR,1163,328799,0,284,56985,0,0,2021-01-25,AR,10450,3993690,49431,1938994,59881,5932684
257,2021-01-25,AR,1163,328799,0,284,56985,0,0,2021-01-25,AR,17699,3465428,1261,869925,18960,4335353
258,2021-01-25,AR,1163,328799,0,284,56985,0,0,2021-01-25,AR,42912,2292365,9505,571165,52417,2863530
259,2021-01-25,AR,1163,328799,0,284,56985,0,0,2021-01-25,AR,5603,1302222,3597,361116,9200,1663338
260,2021-01-25,AR,1163,328799,0,284,56985,0,0,2021-01-25,AR,6850,943069,27,127641,6877,1070710
261,2021-01-25,AR,1163,328799,0,284,56985,0,0,2021-01-25,AR,13022,415081,2280,94595,15302,509676
262,2021-01-25,AR,1163,328799,0,284,56985,0,0,2021-01-25,AR,9295,121099,1520,41201,10815,162300
263,2021-01-25,AR,1163,328799,0,284,56985,0,0,2021-01-25,AR,1059,37972,1032,5974,2091,43946
264,2021-01-18,AR,931,355401,0,200,62857,0,0,2021-01-18,AR,3064,5389375,7814,4559723,10878,9949098
265,2021-01-18,AR,931,355401,0,200,62857,0,0,2021-01-18,AR,8941,5188863,28298,4076676,37239,9265539
266,2021-01-18,AR,931,355401,0,200,62857,0,0,2021-01-18,AR,41165,4539103,16980,3586738,58145,8125841
267,2021-01-18,AR,931,355401,0,200,62857,0,0,2021-01-18,AR,4976,4166116,28539,2912712,33515,7078828
268,2021-01-18,AR,931,355401,0,200,62857,0,0,2021-01-18,AR,14791,3905617,46561,1657862,61352,5563479
269,2021-01-18,AR,931,355401,0,200,62857,0,0,2021-01-18,AR,18693,3201838,5141,785026,23834,3986864
270,2021-01-18,AR,931,355401,0,200,62857,0,0,2021-01-18,AR,50487,2074010,6549,539661,57036,2613671
271,2021-01-18,AR,931,355401,0,200,62857,0,0,2021-01-18,AR,21878,1223125,6000,321429,27878,1544554
272,2021-01-18,AR,931,355401,0,200,62857,0,0,2021-01-18,AR,2852,825176,11,117723,2863,942899
273,2021-01-18,AR,931,355401,0,200,62857,0,0,2021-01-18,AR,13269,352011,5982,81490,19251,433501
274,2021-01-18,AR,931,355401,0,200,62857,0,0,2021-01-18,AR,7236,63150,1527,36847,8763,99997
275,2021-01-18,AR,931,355401,0,200,62857,0,0,2021-01-18,AR,1438,33324,2,11,1440,33335
276,2021-01-25,AR,819,361491,0,174,64189,0,0,2021-01-25,AR,14,5417730,20,4620229,34,10037959
277,2021-01-25,AR,819,361491,0,174,64189,0,0,2021-01-25,AR,7934,5235712,23376,4211100,31310,9446812
278,2021-01-25,AR,819,361491,0,174,64189,0,0,2021-01-25,AR,35599,4788104,16951,3678984,52550,8467088
279,2021-01-25,AR,819,361491,0,174,64189,0,0,2021-01-25,AR,4305,4228084,13224,3111016,17529,7339100
280,2021-01-25,AR,819,361491,0,174,64189,0,0,2021-01-25,AR,10450,3993690,49431,1938994,59881,5932684
281,2021-01-25,AR,819,361491,0,174,64189,0,0,2021-01-25,AR,17699,3465428,1261,869925,18960,4335353
282,2021-01-25,AR,819,361491,0,174,64189,0,0,2021-01-25,AR,42912,2292365,9505,571165,52417,2863530
283,2021-01-25,AR,819,361491,0,174,64189,0,0,2021-01-25,AR,5603,1302222,3597,361116,9200,1663338
284,2021-01-25,AR,819,361491,0,174,64189,0,0,2021-01-25,AR,6850,943069,27,127641,6877,1070710
285,2021-01-25,AR,819,361491,0,174,64189,0,0,2021-01-25,AR,13022,415081,2280,94595,15302,509676
286,2021-01-25,AR,819,361491,0,174,64189,0,0,2021-01-25,AR,9295,121099,1520,41201,10815,162300
287,2021-01-25,AR,819,361491,0,174,64189,0,0,2021-01-25,AR,1059,37972,1032,5974,2091,43946
288,2021-01-18,AR,559,379637,0,112,67835,0,0,2021-01-18,AR,3064,5389375,7814,4559723,10878,9949098
289,2021-01-18,AR,559,379637,0,112,67835,0,0,2021-01-18,AR,8941,5188863,28298,4076676,37239,9265539
290,2021-01-18,AR,559,379637,0,112,67835,0,0,2021-01-18,AR,41165,4539103,16980,3586738,58145,8125841
291,2021-01-18,AR,559,379637,0,112,67835,0,0,2021-01-18,AR,4976,4166116,28539,2912712,33515,7078828
292,2021-01-18,AR,559,379637,0,112,67835,0,0,2021-01-18,AR,14791,3905617,46561,1657862,61352,5563479
293,2021-01-18,AR,559,379637,0,112,67835,0,0,2021-01-18,AR,18693,3201838,5141,785026,23834,3986864
294,2021-01-18,AR,559,379637,0,112,67835,0,0,2021-01-18,AR,50487,2074010,6549,539661,57036,2613671
295,2021-01-18,AR,559,379637,0,112,67835,0,0,2021-01-18,AR,21878,1223125,6000,321429,27878,1544554
296,2021-01-18,AR,559,379637,0,112,67835,0,0,2021-01-18,AR,2852,825176,11,117723,2863,942899
297,2021-01-18,AR,559,379637,0,112,67835,0,0,2021-01-18,AR,13269,352011,5982,81490,19251,433501
298,2021-01-18,AR,559,379637,0,112,67835,0,0,2021-01-18,AR,7236,63150,1527,36847,8763,99997
299,2021-01-18,AR,559,379637,0,112,67835,0,0,2021-01-18,AR,1438,33324,2,11,1440,33335
300,2021-01-25,AR,505,384456,0,108,68744,0,0,2021-01-25,AR,14,5417730,20,4620229,34,10037959
301,2021-01-25,AR,505,384456,0,108,68744,0,0,2021-01-25,AR,7934,5235712,23376,4211100,31310,9446812
302,2021-01-25,AR,505,384456,0,108,68744,0,0,2021-01-25,AR,35599,4788104,16951,3678984,52550,8467088
303,2021-01-25,AR,505,384456,0,108,68744,0,0,2021-01-25,AR,4305,4228084,13224,3111016,17529,7339100
304,2021-01-25,AR,505,384456,0,108,68744,0,0,2021-01-25,AR,10450,3993690,49431,1938994,59881,5932684
305,2021-01-25,AR,505,384456,0,108,68744,0,0,2021-01-25,AR,17699,3465428,1261,869925,18960,4335353
306,2021-01-25,AR,505,384456,0,108,68744,0,0,2021-01-25,AR,42912,2292365,9505,571165,52417,2863530
307,2021-01-25,AR,505,384456,0,108,68744,0,0,2021-01-25,AR,5603,1302222,3597,361116,9200,1663338
308,2021-01-25,AR,505,384456,0,108,68744,0,0,2021-01-25,AR,6850,943069,27,127641,6877,1070710
309,2021-01-25,AR,505,384456,0,108,68744,0,0,2021-01-25,AR,13022,415081,2280,94595,15302,509676
310,2021-01-25,AR,505,384456,0,108,68744,0,0,2021-01-25,AR,9295,121099,1520,41201,10815,162300
311,2021-01-25,AR,505,384456,0,108,68744,0,0,2021-01-25,AR,1059,37972,1032,5974,2091,43946
312,2021-01-18,AR,621,398710,0,102,71358,0,0,2021-01-18,AR,3064,5389375,7814,4559723,10878,9949098
313,2021-01-18,AR,621,398710,0,102,71358,0,0,2021-01-18,AR,8941,5188863,28298,4076676,37239,9265539
314,2021-01-18,AR,621,398710,0,102,71358,0,0,2021-01-18,AR,41165,4539103,16980,3586738,58145,8125841
315,2021-01-18,AR,621,398710,0,102,71358,0,0,2021-01-18,AR,4976,4166116,28539,2912712,33515,7078828
316,2021-01-18,AR,621,398710,0,102,71358,0,0,2021-01-18,AR,14791,3905617,46561,1657862,61352,5563479
317,2021-01-18,AR,621,398710,0,102,71358,0,0,2021-01-18,AR,18693,3201838,5141,785026,23834,3986864
318,2021-01-18,AR,621,398710,0,102,71358,0,0,2021-01-18,AR,50487,2074010,6549,539661,57036,2613671
319,2021-01-18,AR,621,398710,0,102,71358,0,0,2021-01-18,AR,21878,1223125,6000,321429,27878,1544554
320,2021-01-18,AR,621,398710,0,102,71358,0,0,2021-01-18,AR,2852,825176,11,117723,2863,942899
321,2021-01-18,AR,621,398710,0,102,71358,0,0,2021-01-18,AR,13269,352011,5982,81490,19251,433501
322,2021-01-18,AR,621,398710,0,102,71358,0,0,2021-01-18,AR,7236,63150,1527,36847,8763,99997
323,2021-01-18,AR,621,398710,0,102,71358,0,0,2021-01-18,AR,1438,33324,2,11,1440,33335
324,2021-01-25,AR,494,402112,0,79,71909,0,0,2021-01-25,AR,14,5417730,20,4620229,34,10037959
325,2021-01-25,AR,494,402112,0,79,71909,0,0,2021-01-25,AR,7934,5235712,23376,4211100,31310,9446812
326,2021-01-25,AR,494,402112,0,79,71909,0,0,2021-01-25,AR,35599,4788104,16951,3678984,52550,8467088
327,2021-01-25,AR,494,402112,0,79,71909,0,0,2021-01-25,AR,4305,4228084,13224,3111016,17529,7339100
328,2021-01-25,AR,494,402112,0,79,71909,0,0,2021-01-25,AR,10450,3993690,49431,1938994,59881,5932684
329,2021-01-25,AR,494,402112,0,79,71909,0,0,2021-01-25,AR,17699,3465428,1261,869925,18960,4335353
330,2021-01-25,AR,494,402112,0,79,71909,0,0,2021-01-25,AR,42912,2292365,9505,571165,52417,2863530
331,2021-01-25,AR,494,402112,0,79,71909,0,0,2021-01-25,AR,5603,1302222,3597,361116,9200,1663338
332,2021-01-25,AR,494,402112,0,79,71909,0,0,2021-01-25,AR,6850,943069,27,127641,6877,1070710
333,2021-01-25,AR,494,402112,0,79,71909,0,0,2021-01-25,AR,13022,415081,2280,94595,15302,509676
334,2021-01-25,AR,494,402112,0,79,71909,0,0,2021-01-25,AR,9295,121099,1520,41201,10815,162300
335,2021-01-25,AR,494,402112,0,79,71909,0,0,2021-01-25,AR,1059,37972,1032,5974,2091,43946
336,2021-01-18,AR,297,411345,0,41,73231,0,0,2021-01-18,AR,3064,5389375,7814,4559723,10878,9949098
337,2021-01-18,AR,297,411345,0,41,73231,0,0,2021-01-18,AR,8941,5188863,28298,4076676,37239,9265539
338,2021-01-18,AR,297,411345,0,41,73231,0,0,2021-01-18,AR,41165,4539103,16980,3586738,58145,8125841
339,2021-01-18,AR,297,411345,0,41,73231,0,0,2021-01-18,AR,4976,4166116,28539,2912712,33515,7078828
340,2021-01-18,AR,297,411345,0,41,73231,0,0,2021-01-18,AR,14791,3905617,46561,1657862,61352,5563479
341,2021-01-18,AR,297,411345,0,41,73231,0,0,2021-01-18,AR,18693,3201838,5141,785026,23834,3986864
342,2021-01-18,AR,297,411345,0,41,73231,0,0,2021-01-18,AR,50487,2074010,6549,539661,57036,2613671
343,2021-01-18,AR,297,411345,0,41,73231,0,0,2021-01-18,AR,21878,1223125,6000,321429,27878,1544554
344,2021-01-18,AR,297,411345,0,41,73231,0,0,2021-01-18,AR,2852,825176,11,117723,2863,942899
345,2021-01-18,AR,297,411345,0,41,73231,0,0,2021-01-18,AR,13269,352011,5982,81490,19251,433501
346,2021-01-18,AR,297,411345,0,41,73231,0,0,2021-01-18,AR,7236,63150,1527,36847,8763,99997
347,2021-01-18,AR,297,411345,0,41,73231,0,0,2021-01-18,AR,1438,33324,2,11,1440,33335
348,2021-01-25,AR,201,413400,0,25,73469,0,0,2021-01-25,AR,14,5417730,20,4620229,34,10037959
349,2021-01-25,AR,201,413400,0,25,73469,0,0,2021-01-25,AR,7934,5235712,23376,4211100,31310,9446812
350,2021-01-25,AR,201,413400,0,25,73469,0,0,2021-01-25,AR,35599,4788104,16951,3678984,52550,8467088
351,2021-01-25,AR,201,413400,0,25,73469,0,0,2021-01-25,AR,4305,4228084,13224,3111016,17529,7339100
352,2021-01-25,AR,201,413400,0,25,73469,0,0,2021-01-25,AR,10450,3993690,49431,1938994,59881,5932684
353,2021-01-25,AR,201,413400,0,25,73469,0,0,2021-01-25,AR,17699,3465428,1261,869925,18960,4335353
354,2021-01-25,AR,201,413400,0,25,73469,0,0,2021-01-25,AR,42912,2292365,9505,571165,52417,2863530
355,2021-01-25,AR,201,413400,0,25,73469,0,0,2021-01-25,AR,5603,1302222,3597,361116,9200,1663338
356,2021-01-25,AR,201,413400,0,25,73469,0,0,2021-01-25,AR,6850,943069,27,127641,6877,1070710
357,2021-01-25,AR,201,413400,0,25,73469,0,0,2021-01-25,AR,13022,415081,2280,94595,15302,509676
358,2021-01-25,AR,201,413400,0,25,73469,0,0,2021-01-25,AR,9295,121099,1520,41201,10815,162300
359,2021-01-25,AR,201,413400,0,25,73469,0,0,2021-01-25,AR,1059,37972,1032,5974,2091,43946
360,2021-01-18,AR,287,419355,0,44,74189,0,0,2021-01-18,AR,3064,5389375,7814,4559723,10878,9949098
361,2021-01-18,AR,287,419355,0,44,74189,0,0,2021-01-18,AR,8941,5188863,28298,4076676,37239,9265539
362,2021-01-18,AR,287,419355,0,44,74189,0,0,2021-01-18,AR,41165,4539103,16980,3586738,58145,8125841
363,2021-01-18,AR,287,419355,0,44,74189,0,0,2021-01-18,AR,4976,4166116,28539,2912712,33515,7078828
364,2021-01-18,AR,287,419355,0,44,74189,0,0,2021-01-18,AR,14791,3905617,46561,1657862,61352,5563479
365,2021-01-18,AR,287,419355,0,44,74189,0,0,2021-01-18,AR,18693,3201838,5141,785026,23834,3986864
366,2021-01-18,AR,287,419355,0,44,74189,0,0,2021-01-18,AR,50487,2074010,6549,539661,57036,2613671
367,2021-01-18,AR,287,419355,0,44,74189,0,0,2021-01-18,AR,21878,1223125,6000,321429,27878,1544554
368,2021-01-18,AR,287,419355,0,44,74189,0,0,2021-01-18,AR,2852,825176,11,117723,2863,942899
369,2021-01-18,AR,287,419355,0,44,74189,0,0,2021-01-18,AR,13269,352011,5982,81490,19251,433501
370,2021-01-18,AR,287,419355,0,44,74189,0,0,2021-01-18,AR,7236,63150,1527,36847,8763,99997
371,2021-01-18,AR,287,419355,0,44,74189,0,0,2021-01-18,AR,1438,33324,2,11,1440,33335
372,2021-01-25,AR,282,421108,0,39,74400,0,0,2021-01-25,AR,14,5417730,20,4620229,34,10037959
373,2021-01-25,AR,282,421108,0,39,74400,0,0,2021-01-25,AR,7934,5235712,23376,4211100,31310,9446812
374,2021-01-25,AR,282,421108,0,39,74400,0,0,2021-01-25,AR,35599,4788104,16951,3678984,52550,8467088
375,2021-01-25,AR,282,421108,0,39,74400,0,0,2021-01-25,AR,4305,4228084,13224,3111016,17529,7339100
376,2021-01-25,AR,282,421108,0,39,74400,0,0,2021-01-25,AR,10450,3993690,49431,1938994,59881,5932684
377,2021-01-25,AR,282,421108,0,39,74400,0,0,2021-01-25,AR,17699,3465428,1261,869925,18960,4335353
378,2021-01-25,AR,282,421108,0,39,74400,0,0,2021-01-25,AR,42912,2292365,9505,571165,52417,2863530
379,2021-01-25,AR,282,421108,0,39,74400,0,0,2021-01-25,AR,5603,1302222,3597,361116,9200,1663338
380,2021-01-25,AR,282,421108,0,39,74400,0,0,2021-01-25,AR,6850,943069,27,127641,6877,1070710
381,2021-01-25,AR,282,421108,0,39,74400,0,0,2021-01-25,AR,13022,415081,2280,94595,15302,509676
382,2021-01-25,AR,282,421108,0,39,74400,0,0,2021-01-25,AR,9295,121099,1520,41201,10815,162300
383,2021-01-25,AR,282,421108,0,39,74400,0,0,2021-01-25,AR,1059,37972,1032,5974,2091,43946
384,2021-01-18,AR,253,426822,0,38,75074,0,0,2021-01-18,AR,3064,5389375,7814,4559723,10878,9949098
385,2021-01-18,AR,253,426822,0,38,75074,0,0,2021-01-18,AR,8941,5188863,28298,4076676,37239,9265539
386,2021-01-18,AR,253,426822,0,38,75074,0,0,2021-01-18,AR,41165,4539103,16980,3586738,58145,8125841
387,2021-01-18,AR,253,426822,0,38,75074,0,0,2021-01-18,AR,4976,4166116,28539,2912712,33515,7078828
388,2021-01-18,AR,253,426822,0,38,75074,0,0,2021-01-18,AR,14791,3905617,46561,1657862,61352,5563479
389,2021-01-18,AR,253,426822,0,38,75074,0,0,2021-01-18,AR,18693,3201838,5141,785026,23834,3986864
390,2021-01-18,AR,253,426822,0,38,75074,0,0,2021-01-18,AR,50487,2074010,6549,539661,57036,2613671
391,2021-01-18,AR,253,426822,0,38,75074,0,0,2021-01-18,AR,21878,1223125,6000,321429,27878,1544554
392,2021-01-18,AR,253,426822,0,38,75074,0,0,2021-01-18,AR,2852,825176,11,117723,2863,942899
393,2021-01-18,AR,253,426822,0,38,75074,0,0,2021-01-18,AR,13269,352011,5982,81490,19251,433501
394,2021-01-18,AR,253,426822,0,38,75074,0,0,2021-01-18,AR,7236,63150,1527,36847,8763,99997
395,2021-01-18,AR,253,426822,0,38,75074,0,0,2021-01-18,AR,1438,33324,2,11,1440,33335
396,2021-01-25,AR,292,428269,0,37,75289,0,0,2021-01-25,AR,14,5417730,20,4620229,34,10037959
397,2021-01-25,AR,292,428269,0,37,75289,0,0,2021-01-25,AR,7934,5235712,23376,4211100,31310,9446812
398,2021-01-25,AR,292,428269,0,37,75289,0,0,2021-01-25,AR,35599,4788104,16951,3678984,52550,8467088
399,2021-01-25,AR,292,428269,0,37,75289,0,0,2021-01-25,AR,4305,4228084,13224,3111016,17529,7339100
400,2021-01-25,AR,292,428269,0,37,75289,0,0,2021-01-25,AR,10450,3993690,49431,1938994,59881,5932684
401,2021-01-25,AR,292,428269,0,37,75289,0,0,2021-01-25,AR,17699,3465428,1261,869925,18960,4335353
402,2021-01-25,AR,292,428269,0,37,75289,0,0,2021-01-25,AR,42912,2292365,9505,571165,52417,2863530
403,2021-01-25,AR,292,428269,0,37,75289,0,0,2021-01-25,AR,5603,1302222,3597,361116,9200,1663338
404,2021-01-25,AR,292,428269,0,37,75289,0,0,2021-01-25,AR,6850,943069,27,127641,6877,1070710
405,2021-01-25,AR,292,428269,0,37,75289,0,0,2021-01-25,AR,13022,415081,2280,94595,15302,509676
406,2021-01-25,AR,292,428269,0,37,75289,0,0,2021-01-25,AR,9295,121099,1520,41201,10815,162300
407,2021-01-25,AR,292,428269,0,37,75289,0,0,2021-01-25,AR,1059,37972,1032,5974,2091,43946
408,2021-01-18,AR,173,433286,0,34,76005,0,0,2021-01-18,AR,3064,5389375,7814,4559723,10878,9949098
409,2021-01-18,AR,173,433286,0,34,76005,0,0,2021-01-18,AR,8941,5188863,28298,4076676,37239,9265539
410,2021-01-18,AR,173,433286,0,34,76005,0,0,2021-01-18,AR,41165,4539103,16980,3586738,58145,8125841
411,2021-01-18,AR,173,433286,0,34,76005,0,0,2021-01-18,AR,4976,4166116,28539,2912712,33515,7078828
412,2021-01-18,AR,173,433286,0,34,76005,0,0,2021-01-18,AR,14791,3905617,46561,1657862,61352,5563479
413,2021-01-18,AR,173,433286,0,34,76005,0,0,2021-01-18,AR,18693,3201838,5141,785026,23834,3986864
414,2021-01-18,AR,173,433286,0,34,76005,0,0,2021-01-18,AR,50487,2074010,6549,539661,57036,2613671
415,2021-01-18,AR,173,433286,0,34,76005,0,0,2021-01-18,AR,21878,1223125,6000,321429,27878,1544554
416,2021-01-18,AR,173,433286,0,34,76005,0,0,2021-01-18,AR,2852,825176,11,117723,2863,942899
417,2021-01-18,AR,173,433286,0,34,76005,0,0,2021-01-18,AR,13269,352011,5982,81490,19251,433501
418,2021-01-18,AR,173,433286,0,34,76005,0,0,2021-01-18,AR,7236,63150,1527,36847,8763,99997
419,2021-01-18,AR,173,433286,0,34,76005,0,0,2021-01-18,AR,1438,33324,2,11,1440,33335
420,2021-01-25,AR,188,434832,0,27,76252,0,0,2021-01-25,AR,14,5417730,20,4620229,34,10037959
421,2021-01-25,AR,188,434832,0,27,76252,0,0,2021-01-25,AR,7934,5235712,23376,4211100,31310,9446812
422,2021-01-25,AR,188,434832,0,27,76252,0,0,2021-01-25,AR,35599,4788104,16951,3678984,52550,8467088
423,2021-01-25,AR,188,434832,0,27,76252,0,0,2021-01-25,AR,4305,4228084,13224,3111016,17529,7339100
424,2021-01-25,AR,188,434832,0,27,76252,0,0,2021-01-25,AR,10450,3993690,49431,1938994,59881,5932684
425,2021-01-25,AR,188,434832,0,27,76252,0,0,2021-01-25,AR,17699,3465428,1261,869925,18960,4335353
426,2021-01-25,AR,188,434832,0,27,76252,0,0,2021-01-25,AR,42912,2292365,9505,571165,52417,2863530
427,2021-01-25,AR,188,434832,0,27,76252,0,0,2021-01-25,AR,5603,1302222,3597,361116,9200,1663338
428,2021-01-25,AR,188,434832,0,27,76252,0,0,2021-01-25,AR,6850,943069,27,127641,6877,1070710
429,2021-01-25,AR,188,434832,0,27,76252,0,0,2021-01-25,AR,13022,415081,2280,94595,15302,509676
430,2021-01-25,AR,188,434832,0,27,76252,0,0,2021-01-25,AR,9295,121099,1520,41201,10815,162300
431,2021-01-25,AR,188,434832,0,27,76252,0,0,2021-01-25,AR,1059,37972,1032,5974,2091,43946
432,2021-01-05,AR,650,236074,0,113,37776,0,0,2021-01-05,AR,2690,5308371,6341,4373643,9031,9682014
433,2021-01-05,AR,650,236074,0,113,37776,0,0,2021-01-05,AR,19611,5057159,15836,3845345,35447,8902504
434,2021-01-05,AR,650,236074,0,113,37776,0,0,2021-01-05,AR,15670,4302614,22957,3374762,38627,7677376
435,2021-01-05,AR,650,236074,0,113,37776,0,0,2021-01-05,AR,2438,4090218,26635,2414166,29073,6504384
436,2021-01-05,AR,650,236074,0,113,37776,0,0,2021-01-05,AR,22170,3758698,40205,1185590,62375,4944288
437,2021-01-05,AR,650,236074,0,113,37776,0,0,2021-01-05,AR,32851,2673250,23507,672911,56358,3346161
438,2021-01-05,AR,650,236074,0,113,37776,0,0,2021-01-05,AR,44602,1631665,2855,445436,47457,2077101
439,2021-01-05,AR,650,236074,0,113,37776,0,0,2021-01-05,AR,22540,1097130,10991,178157,33531,1275287
440,2021-01-05,AR,650,236074,0,113,37776,0,0,2021-01-05,AR,21942,567443,1507,100635,23449,668078
441,2021-01-05,AR,650,236074,0,113,37776,0,0,2021-01-05,AR,13985,189124,1880,49872,15865,238996
442,2021-01-05,AR,650,236074,0,113,37776,0,0,2021-01-05,AR,1949,45494,2706,26833,4655,72327
443,2021-01-05,AR,650,236074,0,113,37776,0,0,2021-01-05,AR,1514,9456,0,1,1514,9457
444,2021-01-05,AR,494,253190,0,109,41117,0,0,2021-01-05,AR,2690,5308371,6341,4373643,9031,9682014
445,2021-01-05,AR,494,253190,0,109,41117,0,0,2021-01-05,AR,19611,5057159,15836,3845345,35447,8902504
446,2021-01-05,AR,494,253190,0,109,41117,0,0,2021-01-05,AR,15670,4302614,22957,3374762,38627,7677376
447,2021-01-05,AR,494,253190,0,109,41117,0,0,2021-01-05,AR,2438,4090218,26635,2414166,29073,6504384
448,2021-01-05,AR,494,253190,0,109,41117,0,0,2021-01-05,AR,22170,3758698,40205,1185590,62375,4944288
449,2021-01-05,AR,494,253190,0,109,41117,0,0,2021-01-05,AR,32851,2673250,23507,672911,56358,3346161
450,2021-01-05,AR,494,253190,0,109,41117,0,0,2021-01-05,AR,44602,1631665,2855,445436,47457,2077101
451,2021-01-05,AR,494,253190,0,109,41117,0,0,2021-01-05,AR,22540,1097130,10991,178157,33531,1275287
452,2021-01-05,AR,494,253190,0,109,41117,0,0,2021-01-05,AR,21942,567443,1507,100635,23449,668078
453,2021-01-05,AR,494,253190,0,109,41117,0,0,2021-01-05,AR,13985,189124,1880,49872,15865,238996
454,2021-01-05,AR,494,253190,0,109,41117,0,0,2021-01-05,AR,1949,45494,2706,26833,4655,72327
455,2021-01-05,AR,494,253190,0,109,41117,0,0,2021-01-05,AR,1514,9456,0,1,1514,9457
456,2021-01-05,AR,418,265658,0,62,43468,0,0,2021-01-05,AR,2690,5308371,6341,4373643,9031,9682014
457,2021-01-05,AR,418,265658,0,62,43468,0,0,2021-01-05,AR,19611,5057159,15836,3845345,35447,8902504
458,2021-01-05,AR,418,265658,0,62,43468,0,0,2021-01-05,AR,15670,4302614,22957,3374762,38627,7677376
459,2021-01-05,AR,418,265658,0,62,43468,0,0,2021-01-05,AR,2438,4090218,26635,2414166,29073,6504384
460,2021-01-05,AR,418,265658,0,62,43468,0,0,2021-01-05,AR,22170,3758698,40205,1185590,62375,4944288
461,2021-01-05,AR,418,265658,0,62,43468,0,0,2021-01-05,AR,32851,2673250,23507,672911,56358,3346161
462,2021-01-05,AR,418,265658,0,62,43468,0,0,2021-01-05,AR,44602,1631665,2855,445436,47457,2077101
463,2021-01-05,AR,418,265658,0,62,43468,0,0,2021-01-05,AR,22540,1097130,10991,178157,33531,1275287
464,2021-01-05,AR,418,265658,0,62,43468,0,0,2021-01-05,AR,21942,567443,1507,100635,23449,668078
465,2021-01-05,AR,418,265658,0,62,43468,0,0,2021-01-05,AR,13985,189124,1880,49872,15865,238996
466,2021-01-05,AR,418,265658,0,62,43468,0,0,2021-01-05,AR,1949,45494,2706,26833,4655,72327
467,2021-01-05,AR,418,265658,0,62,43468,0,0,2021-01-05,AR,1514,9456,0,1,1514,9457
468,2021-01-05,AR,798,281419,0,164,46698,0,0,2021-01-05,AR,2690,5308371,6341,4373643,9031,9682014
469,2021-01-05,AR,798,281419,0,164,46698,0,0,2021-01-05,AR,19611,5057159,15836,3845345,35447,8902504
470,2021-01-05,AR,798,281419,0,164,46698,0,0,2021-01-05,AR,15670,4302614,22957,3374762,38627,7677376
471,2021-01-05,AR,798,281419,0,164,46698,0,0,2021-01-05,AR,2438,4090218,26635,2414166,29073,6504384
472,2021-01-05,AR,798,281419,0,164,46698,0,0,2021-01-05,AR,22170,3758698,40205,1185590,62375,4944288
473,2021-01-05,AR,798,281419,0,164,46698,0,0,2021-01-05,AR,32851,2673250,23507,672911,56358,3346161
474,2021-01-05,AR,798,281419,0,164,46698,0,0,2021-01-05,AR,44602,1631665,2855,445436,47457,2077101
475,2021-01-05,AR,798,281419,0,164,46698,0,0,2021-01-05,AR,22540,1097130,10991,178157,33531,1275287
476,2021-01-05,AR,798,281419,0,164,46698,0,0,2021-01-05,AR,21942,567443,1507,100635,23449,668078
477,2021-01-05,AR,798,281419,0,164,46698,0,0,2021-01-05,AR,13985,189124,1880,49872,15865,238996
478,2021-01-05,AR,798,281419,0,164,46698,0,0,2021-01-05,AR,1949,45494,2706,26833,4655,72327
479,2021-01-05,AR,798,281419,0,164,46698,0,0,2021-01-05,AR,1514,9456,0,1,1514,9457
480,2021-01-05,AR,969,308170,0,230,52358,0,0,2021-01-05,AR,2690,5308371,6341,4373643,9031,9682014
481,2021-01-05,AR,969,308170,0,230,52358,0,0,2021-01-05,AR,19611,5057159,15836,3845345,35447,8902504
482,2021-01-05,AR,969,308170,0,230,52358,0,0,2021-01-05,AR,15670,4302614,22957,3374762,38627,7677376
483,2021-01-05,AR,969,308170,0,230,52358,0,0,2021-01-05,AR,2438,4090218,26635,2414166,29073,6504384
484,2021-01-05,AR,969,308170,0,230,52358,0,0,2021-01-05,AR,22170,3758698,40205,1185590,62375,4944288
485,2021-01-05,AR,969,308170,0,230,52358,0,0,2021-01-05,AR,32851,2673250,23507,672911,56358,3346161
486,2021-01-05,AR,969,308170,0,230,52358,0,0,2021-01-05,AR,44602,1631665,2855,445436,47457,2077101
487,2021-01-05,AR,969,308170,0,230,52358,0,0,2021-01-05,AR,22540,1097130,10991,178157,33531,1275287
488,2021-01-05,AR,969,308170,0,230,52358,0,0,2021-01-05,AR,21942,567443,1507,100635,23449,668078
489,2021-01-05,AR,969,308170,0,230,52358,0,0,2021-01-05,AR,13985,189124,1880,49872,15865,238996
490,2021-01-05,AR,969,308170,0,230,52358,0,0,2021-01-05,AR,1949,45494,2706,26833,4655,72327
491,2021-01-05,AR,969,308170,0,230,52358,0,0,2021-01-05,AR,1514,9456,0,1,1514,9457
492,2021-01-05,AR,977,342157,0,264,59911,0,0,2021-01-05,AR,2690,5308371,6341,4373643,9031,9682014
493,2021-01-05,AR,977,342157,0,264,59911,0,0,2021-01-05,AR,19611,5057159,15836,3845345,35447,8902504
494,2021-01-05,AR,977,342157,0,264,59911,0,0,2021-01-05,AR,15670,4302614,22957,3374762,38627,7677376
495,2021-01-05,AR,977,342157,0,264,59911,0,0,2021-01-05,AR,2438,4090218,26635,2414166,29073,6504384
496,2021-01-05,AR,977,342157,0,264,59911,0,0,2021-01-05,AR,22170,3758698,40205,1185590,62375,4944288
497,2021-01-05,AR,977,342157,0,264,59911,0,0,2021-01-05,AR,32851,2673250,23507,672911,56358,3346161
498,2021-01-05,AR,977,342157,0,264,59911,0,0,2021-01-05,AR,44602,1631665,2855,445436,47457,2077101
499,2021-01-05,AR,977,342157,0,264,59911,0,0,2021-01-05,AR,22540,1097130,10991,178157,33531,1275287
500,2021-01-05,AR,977,342157,0,264,59911,0,0,2021-01-05,AR,21942,567443,1507,100635,23449,668078
501,2021-01-05,AR,977,342157,0,264,59911,0,0,2021-01-05,AR,13985,189124,1880,49872,15865,238996
502,2021-01-05,AR,977,342157,0,264,59911,0,0,2021-01-05,AR,1949,45494,2706,26833,4655,72327
503,2021-01-05,AR,977,342157,0,264,59911,0,0,2021-01-05,AR,1514,9456,0,1,1514,9457
504,2021-01-05,AR,922,369617,0,186,65855,0,0,2021-01-05,AR,2690,5308371,6341,4373643,9031,9682014
505,2021-01-05,AR,922,369617,0,186,65855,0,0,2021-01-05,AR,19611,5057159,15836,3845345,35447,8902504
506,2021-01-05,AR,922,369617,0,186,65855,0,0,2021-01-05,AR,15670,4302614,22957,3374762,38627,7677376
507,2021-01-05,AR,922,369617,0,186,65855,0,0,2021-01-05,AR,2438,4090218,26635,2414166,29073,6504384
508,2021-01-05,AR,922,369617,0,186,65855,0,0,2021-01-05,AR,22170,3758698,40205,1185590,62375,4944288
509,2021-01-05,AR,922,369617,0,186,65855,0,0,2021-01-05,AR,32851,2673250,23507,672911,56358,3346161
510,2021-01-05,AR,922,369617,0,186,65855,0,0,2021-01-05,AR,44602,1631665,2855,445436,47457,2077101
511,2021-01-05,AR,922,369617,0,186,65855,0,0,2021-01-05,AR,22540,1097130,10991,178157,33531,1275287
512,2021-01-05,AR,922,369617,0,186,65855,0,0,2021-01-05,AR,21942,567443,1507,100635,23449,668078
513,2021-01-05,AR,922,369617,0,186,65855,0,0,2021-01-05,AR,13985,189124,1880,49872,15865,238996
514,2021-01-05,AR,922,369617,0,186,65855,0,0,2021-01-05,AR,1949,45494,2706,26833,4655,72327
515,2021-01-05,AR,922,369617,0,186,65855,0,0,2021-01-05,AR,1514,9456,0,1,1514,9457
516,2021-01-05,AR,595,391539,0,118,70048,0,0,2021-01-05,AR,2690,5308371,6341,4373643,9031,9682014
517,2021-01-05,AR,595,391539,0,118,70048,0,0,2021-01-05,AR,19611,5057159,15836,3845345,35447,8902504
518,2021-01-05,AR,595,391539,0,118,70048,0,0,2021-01-05,AR,15670,4302614,22957,3374762,38627,7677376
519,2021-01-05,AR,595,391539,0,118,70048,0,0,2021-01-05,AR,2438,4090218,26635,2414166,29073,6504384
520,2021-01-05,AR,595,391539,0,118,70048,0,0,2021-01-05,AR,22170,3758698,40205,1185590,62375,4944288
521,2021-01-05,AR,595,391539,0,118,70048,0,0,2021-01-05,AR,32851,2673250,23507,672911,56358,3346161
522,2021-01-05,AR,595,391539,0,118,70048,0,0,2021-01-05,AR,44602,1631665,2855,445436,47457,2077101
523,2021-01-05,AR,595,391539,0,118,70048,0,0,2021-01-05,AR,22540,1097130,10991,178157,33531,1275287
524,2021-01-05,AR,595,391539,0,118,70048,0,0,2021-01-05,AR,21942,567443,1507,100635,23449,668078
525,2021-01-05,AR,595,391539,0,118,70048,0,0,2021-01-05,AR,13985,189124,1880,49872,15865,238996
526,2021-01-05,AR,595,391539,0,118,70048,0,0,2021-01-05,AR,1949,45494,2706,26833,4655,72327
527,2021-01-05,AR,595,391539,0,118,70048,0,0,2021-01-05,AR,1514,9456,0,1,1514,9457
528,2021-01-05,AR,292,406710,0,51,72600,0,0,2021-01-05,AR,2690,5308371,6341,4373643,9031,9682014
529,2021-01-05,AR,292,406710,0,51,72600,0,0,2021-01-05,AR,19611,5057159,15836,3845345,35447,8902504
530,2021-01-05,AR,292,406710,0,51,72600,0,0,2021-01-05,AR,15670,4302614,22957,3374762,38627,7677376
531,2021-01-05,AR,292,406710,0,51,72600,0,0,2021-01-05,AR,2438,4090218,26635,2414166,29073,6504384
532,2021-01-05,AR,292,406710,0,51,72600,0,0,2021-01-05,AR,22170,3758698,40205,1185590,62375,4944288
533,2021-01-05,AR,292,406710,0,51,72600,0,0,2021-01-05,AR,32851,2673250,23507,672911,56358,3346161
534,2021-01-05,AR,292,406710,0,51,72600,0,0,2021-01-05,AR,44602,1631665,2855,445436,47457,2077101
535,2021-01-05,AR,292,406710,0,51,72600,0,0,2021-01-05,AR,22540,1097130,10991,178157,33531,1275287
536,2021-01-05,AR,292,406710,0,51,72600,0,0,2021-01-05,AR,21942,567443,1507,100635,23449,668078
537,2021-01-05,AR,292,406710,0,51,72600,0,0,2021-01-05,AR,13985,189124,1880,49872,15865,238996
538,2021-01-05,AR,292,406710,0,51,72600,0,0,2021-01-05,AR,1949,45494,2706,26833,4655,72327
539,2021-01-05,AR,292,406710,0,51,72600,0,0,2021-01-05,AR,1514,9456,0,1,1514,9457
540,2021-01-05,AR,273,416106,0,41,73801,0,0,2021-01-05,AR,2690,5308371,6341,4373643,9031,9682014
541,2021-01-05,AR,273,416106,0,41,73801,0,0,2021-01-05,AR,19611,5057159,15836,3845345,35447,8902504
542,2021-01-05,AR,273,416106,0,41,73801,0,0,2021-01-05,AR,15670,4302614,22957,3374762,38627,7677376
543,2021-01-05,AR,273,416106,0,41,73801,0,0,2021-01-05,AR,2438,4090218,26635,2414166,29073,6504384
544,2021-01-05,AR,273,416106,0,41,73801,0,0,2021-01-05,AR,22170,3758698,40205,1185590,62375,4944288
545,2021-01-05,AR,273,416106,0,41,73801,0,0,2021-01-05,AR,32851,2673250,23507,672911,56358,3346161
546,2021-01-05,AR,273,416106,0,41,73801,0,0,2021-01-05,AR,44602,1631665,2855,445436,47457,2077101
547,2021-01-05,AR,273,416106,0,41,73801,0,0,2021-01-05,AR,22540,1097130,10991,178157,33531,1275287
548,2021-01-05,AR,273,416106,0,41,73801,0,0,2021-01-05,AR,21942,567443,1507,100635,23449,668078
549,2021-01-05,AR,273,416106,0,41,73801,0,0,2021-01-05,AR,13985,189124,1880,49872,15865,238996
550,2021-01-05,AR,273,416106,0,41,73801,0,0,2021-01-05,AR,1949,45494,2706,26833,4655,72327
551,2021-01-05,AR,273,416106,0,41,73801,0,0,2021-01-05,AR,1514,9456,0,1,1514,9457
552,2021-01-05,AR,189,423875,0,25,74718,0,0,2021-01-05,AR,2690,5308371,6341,4373643,9031,9682014
553,2021-01-05,AR,189,423875,0,25,74718,0,0,2021-01-05,AR,19611,5057159,15836,3845345,35447,8902504
554,2021-01-05,AR,189,423875,0,25,74718,0,0,2021-01-05,AR,15670,4302614,22957,3374762,38627,7677376
555,2021-01-05,AR,189,423875,0,25,74718,0,0,2021-01-05,AR,2438,4090218,26635,2414166,29073,6504384
556,2021-01-05,AR,189,423875,0,25,74718,0,0,2021-01-05,AR,22170,3758698,40205,1185590,62375,4944288
557,2021-01-05,AR,189,423875,0,25,74718,0,0,2021-01-05,AR,32851,2673250,23507,672911,56358,3346161
558,2021-01-05,AR,189,423875,0,25,74718,0,0,2021-01-05,AR,44602,1631665,2855,445436,47457,2077101
559,2021-01-05,AR,189,423875,0,25,74718,0,0,2021-01-05,AR,22540,1097130,10991,178157,33531,1275287
560,2021-01-05,AR,189,423875,0,25,74718,0,0,2021-01-05,AR,21942,567443,1507,100635,23449,668078
561,2021-01-05,AR,189,423875,0,25,74718,0,0,2021-01-05,AR,13985,189124,1880,49872,15865,238996
562,2021-01-05,AR,189,423875,0,25,74718,0,0,2021-01-05,AR,1949,45494,2706,26833,4655,72327
563,2021-01-05,AR,189,423875,0,25,74718,0,0,2021-01-05,AR,1514,9456,0,1,1514,9457
564,2021-01-05,AR,174,430416,0,28,75578,0,0,2021-01-05,AR,2690,5308371,6341,4373643,9031,9682014
565,2021-01-05,AR,174,430416,0,28,75578,0,0,2021-01-05,AR,19611,5057159,15836,3845345,35447,8902504
566,2021-01-05,AR,174,430416,0,28,75578,0,0,2021-01-05,AR,15670,4302614,22957,3374762,38627,7677376
567,2021-01-05,AR,174,430416,0,28,75578,0,0,2021-01-05,AR,2438,4090218,26635,2414166,29073,6504384
568,2021-01-05,AR,174,430416,0,28,75578,0,0,2021-01-05,AR,22170,3758698,40205,1185590,62375,4944288
569,2021-01-05,AR,174,430416,0,28,75578,0,0,2021-01-05,AR,32851,2673250,23507,672911,56358,3346161
570,2021-01-05,AR,174,430416,0,28,75578,0,0,2021-01-05,AR,44602,1631665,2855,445436,47457,2077101
571,2021-01-05,AR,174,430416,0,28,75578,0,0,2021-01-05,AR,22540,1097130,10991,178157,33531,1275287
572,2021-01-05,AR,174,430416,0,28,75578,0,0,2021-01-05,AR,21942,567443,1507,100635,23449,668078
573,2021-01-05,AR,174,430416,0,28,75578,0,0,2021-01-05,AR,13985,189124,1880,49872,15865,238996
574,2021-01-05,AR,174,430416,0,28,75578,0,0,2021-01-05,AR,1949,45494,2706,26833,4655,72327
575,2021-01-05,AR,174,430416,0,28,75578,0,0,2021-01-05,AR,1514,9456,0,1,1514,9457
576,2021-01-19,AR,597,244398,0,121,39292,0,0,2021-01-19,AR,1483,5390858,3933,4563656,5416,9954514
577,2021-01-19,AR,597,244398,0,121,39292,0,0,2021-01-19,AR,8030,5196893,34233,4110909,42263,9307802
578,2021-01-19,AR,597,244398,0,121,39292,0,0,2021-01-19,AR,43175,4582278,15466,3602204,58641,8184482
579,2021-01-19,AR,597,244398,0,121,39292,0,0,2021-01-19,AR,2729,4168845,17607,2930319,20336,7099164
580,2021-01-19,AR,597,244398,0,121,39292,0,0,2021-01-19,AR,17260,3922877,44129,1701991,61389,5624868
581,2021-01-19,AR,597,244398,0,121,39292,0,0,2021-01-19,AR,48523,3250361,11391,796417,59914,4046778
582,2021-01-19,AR,597,244398,0,121,39292,0,0,2021-01-19,AR,30432,2104442,3195,542856,33627,2647298
583,2021-01-19,AR,597,244398,0,121,39292,0,0,2021-01-19,AR,18499,1241624,5204,326633,23703,1568257
584,2021-01-19,AR,597,244398,0,121,39292,0,0,2021-01-19,AR,11225,836401,2101,119824,13326,956225
585,2021-01-19,AR,597,244398,0,121,39292,0,0,2021-01-19,AR,12560,364571,5019,86509,17579,451080
586,2021-01-19,AR,597,244398,0,121,39292,0,0,2021-01-19,AR,8183,71333,1030,37877,9213,109210
587,2021-01-19,AR,597,244398,0,121,39292,0,0,2021-01-19,AR,1146,34470,742,753,1888,35223
588,2021-01-19,AR,460,259358,0,92,42334,0,0,2021-01-19,AR,1483,5390858,3933,4563656,5416,9954514
589,2021-01-19,AR,460,259358,0,92,42334,0,0,2021-01-19,AR,8030,5196893,34233,4110909,42263,9307802
590,2021-01-19,AR,460,259358,0,92,42334,0,0,2021-01-19,AR,43175,4582278,15466,3602204,58641,8184482
591,2021-01-19,AR,460,259358,0,92,42334,0,0,2021-01-19,AR,2729,4168845,17607,2930319,20336,7099164
592,2021-01-19,AR,460,259358,0,92,42334,0,0,2021-01-19,AR,17260,3922877,44129,1701991,61389,5624868
593,2021-01-19,AR,460,259358,0,92,42334,0,0,2021-01-19,AR,48523,3250361,11391,796417,59914,4046778
594,2021-01-19,AR,460,259358,0,92,42334,0,0,2021-01-19,AR,30432,2104442,3195,542856,33627,2647298
595,2021-01-19,AR,460,259358,0,92,42334,0,0,2021-01-19,AR,18499,1241624,5204,326633,23703,1568257
596,2021-01-19,AR,460,259358,0,92,42334,0,0,2021-01-19,AR,11225,836401,2101,119824,13326,956225
597,2021-01-19,AR,460,259358,0,92,42334,0,0,2021-01-19,AR,12560,364571,5019,86509,17579,451080
598,2021-01-19,AR,460,259358,0,92,42334,0,0,2021-01-19,AR,8183,71333,1030,37877,9213,109210
599,2021-01-19,AR,460,259358,0,92,42334,0,0,2021-01-19,AR,1146,34470,742,753,1888,35223
600,2021-01-19,AR,497,272122,0,101,44757,0,0,2021-01-19,AR,1483,5390858,3933,4563656,5416,9954514
601,2021-01-19,AR,497,272122,0,101,44757,0,0,2021-01-19,AR,8030,5196893,34233,4110909,42263,9307802
602,2021-01-19,AR,497,272122,0,101,44757,0,0,2021-01-19,AR,43175,4582278,15466,3602204,58641,8184482
603,2021-01-19,AR,497,272122,0,101,44757,0,0,2021-01-19,AR,2729,4168845,17607,2930319,20336,7099164
604,2021-01-19,AR,497,272122,0,101,44757,0,0,2021-01-19,AR,17260,3922877,44129,1701991,61389,5624868
605,2021-01-19,AR,497,272122,0,101,44757,0,0,2021-01-19,AR,48523,3250361,11391,796417,59914,4046778
606,2021-01-19,AR,497,272122,0,101,44757,0,0,2021-01-19,AR,30432,2104442,3195,542856,33627,2647298
607,2021-01-19,AR,497,272122,0,101,44757,0,0,2021-01-19,AR,18499,1241624,5204,326633,23703,1568257
608,2021-01-19,AR,497,272122,0,101,44757,0,0,2021-01-19,AR,11225,836401,2101,119824,13326,956225
609,2021-01-19,AR,497,272122,0,101,44757,0,0,2021-01-19,AR,12560,364571,5019,86509,17579,451080
610,2021-01-19,AR,497,272122,0,101,44757,0,0,2021-01-19,AR,8183,71333,1030,37877,9213,109210
611,2021-01-19,AR,497,272122,0,101,44757,0,0,2021-01-19,AR,1146,34470,742,753,1888,35223
612,2021-01-19,AR,1019,293524,0,216,49154,0,0,2021-01-19,AR,1483,5390858,3933,4563656,5416,9954514
613,2021-01-19,AR,1019,293524,0,216,49154,0,0,2021-01-19,AR,8030,5196893,34233,4110909,42263,9307802
614,2021-01-19,AR,1019,293524,0,216,49154,0,0,2021-01-19,AR,43175,4582278,15466,3602204,58641,8184482
615,2021-01-19,AR,1019,293524,0,216,49154,0,0,2021-01-19,AR,2729,4168845,17607,2930319,20336,7099164
616,2021-01-19,AR,1019,293524,0,216,49154,0,0,2021-01-19,AR,17260,3922877,44129,1701991,61389,5624868
617,2021-01-19,AR,1019,293524,0,216,49154,0,0,2021-01-19,AR,48523,3250361,11391,796417,59914,4046778
618,2021-01-19,AR,1019,293524,0,216,49154,0,0,2021-01-19,AR,30432,2104442,3195,542856,33627,2647298
619,2021-01-19,AR,1019,293524,0,216,49154,0,0,2021-01-19,AR,18499,1241624,5204,326633,23703,1568257
620,2021-01-19,AR,1019,293524,0,216,49154,0,0,2021-01-19,AR,11225,836401,2101,119824,13326,956225
621,2021-01-19,AR,1019,293524,0,216,49154,0,0,2021-01-19,AR,12560,364571,5019,86509,17579,451080
622,2021-01-19,AR,1019,293524,0,216,49154,0,0,2021-01-19,AR,8183,71333,1030,37877,9213,109210
623,2021-01-19,AR,1019,293524,0,216,49154,0,0,2021-01-19,AR,1146,34470,742,753,1888,35223
624,2021-01-19,AR,1232,322199,0,280,55432,0,0,2021-01-19,AR,1483,5390858,3933,4563656,5416,9954514
625,2021-01-19,AR,1232,322199,0,280,55432,0,0,2021-01-19,AR,8030,5196893,34233,4110909,42263,9307802
626,2021-01-19,AR,1232,322199,0,280,55432,0,0,2021-01-19,AR,43175,4582278,15466,3602204,58641,8184482
627,2021-01-19,AR,1232,322199,0,280,55432,0,0,2021-01-19,AR,2729,4168845,17607,2930319,20336,7099164
628,2021-01-19,AR,1232,322199,0,280,55432,0,0,2021-01-19,AR,17260,3922877,44129,1701991,61389,5624868
629,2021-01-19,AR,1232,322199,0,280,55432,0,0,2021-01-19,AR,48523,3250361,11391,796417,59914,4046778
630,2021-01-19,AR,1232,322199,0,280,55432,0,0,2021-01-19,AR,30432,2104442,3195,542856,33627,2647298
631,2021-01-19,AR,1232,322199,0,280,55432,0,0,2021-01-19,AR,18499,1241624,5204,326633,23703,1568257
632,2021-01-19,AR,1232,322199,0,280,55432,0,0,2021-01-19,AR,11225,836401,2101,119824,13326,956225
633,2021-01-19,AR,1232,322199,0,280,55432,0,0,2021-01-19,AR,12560,364571,5019,86509,17579,451080
634,2021-01-19,AR,1232,322199,0,280,55432,0,0,2021-01-19,AR,8183,71333,1030,37877,9213,109210
635,2021-01-19,AR,1232,322199,0,280,55432,0,0,2021-01-19,AR,1146,34470,742,753,1888,35223
636,2021-01-19,AR,791,356192,0,175,63032,0,0,2021-01-19,AR,1483,5390858,3933,4563656,5416,9954514
637,2021-01-19,AR,791,356192,0,175,63032,0,0,2021-01-19,AR,8030,5196893,34233,4110909,42263,9307802
638,2021-01-19,AR,791,356192,0,175,63032,0,0,2021-01-19,AR,43175,4582278,15466,3602204,58641,8184482
639,2021-01-19,AR,791,356192,0,175,63032,0,0,2021-01-19,AR,2729,4168845,17607,2930319,20336,7099164
640,2021-01-19,AR,791,356192,0,175,63032,0,0,2021-01-19,AR,17260,3922877,44129,1701991,61389,5624868
641,2021-01-19,AR,791,356192,0,175,63032,0,0,2021-01-19,AR,48523,3250361,11391,796417,59914,4046778
642,2021-01-19,AR,791,356192,0,175,63032,0,0,2021-01-19,AR,30432,2104442,3195,542856,33627,2647298
643,2021-01-19,AR,791,356192,0,175,63032,0,0,2021-01-19,AR,18499,1241624,5204,326633,23703,1568257
644,2021-01-19,AR,791,356192,0,175,63032,0,0,2021-01-19,AR,11225,836401,2101,119824,13326,956225
645,2021-01-19,AR,791,356192,0,175,63032,0,0,2021-01-19,AR,12560,364571,5019,86509,17579,451080
646,2021-01-19,AR,791,356192,0,175,63032,0,0,2021-01-19,AR,8183,71333,1030,37877,9213,109210
647,2021-01-19,AR,791,356192,0,175,63032,0,0,2021-01-19,AR,1146,34470,742,753,1888,35223
648,2021-01-19,AR,822,380459,0,165,68000,0,0,2021-01-19,AR,1483,5390858,3933,4563656,5416,9954514
649,2021-01-19,AR,822,380459,0,165,68000,0,0,2021-01-19,AR,8030,5196893,34233,4110909,42263,9307802
650,2021-01-19,AR,822,380459,0,165,68000,0,0,2021-01-19,AR,43175,4582278,15466,3602204,58641,8184482
651,2021-01-19,AR,822,380459,0,165,68000,0,0,2021-01-19,AR,2729,4168845,17607,2930319,20336,7099164
652,2021-01-19,AR,822,380459,0,165,68000,0,0,2021-01-19,AR,17260,3922877,44129,1701991,61389,5624868
653,2021-01-19,AR,822,380459,0,165,68000,0,0,2021-01-19,AR,48523,3250361,11391,796417,59914,4046778
654,2021-01-19,AR,822,380459,0,165,68000,0,0,2021-01-19,AR,30432,2104442,3195,542856,33627,2647298
655,2021-01-19,AR,822,380459,0,165,68000,0,0,2021-01-19,AR,18499,1241624,5204,326633,23703,1568257
656,2021-01-19,AR,822,380459,0,165,68000,0,0,2021-01-19,AR,11225,836401,2101,119824,13326,956225
657,2021-01-19,AR,822,380459,0,165,68000,0,0,2021-01-19,AR,12560,364571,5019,86509,17579,451080
658,2021-01-19,AR,822,380459,0,165,68000,0,0,2021-01-19,AR,8183,71333,1030,37877,9213,109210
659,2021-01-19,AR,822,380459,0,165,68000,0,0,2021-01-19,AR,1146,34470,742,753,1888,35223
660,2021-01-19,AR,529,399239,0,99,71457,0,0,2021-01-19,AR,1483,5390858,3933,4563656,5416,9954514
661,2021-01-19,AR,529,399239,0,99,71457,0,0,2021-01-19,AR,8030,5196893,34233,4110909,42263,9307802
662,2021-01-19,AR,529,399239,0,99,71457,0,0,2021-01-19,AR,43175,4582278,15466,3602204,58641,8184482
663,2021-01-19,AR,529,399239,0,99,71457,0,0,2021-01-19,AR,2729,4168845,17607,2930319,20336,7099164
664,2021-01-19,AR,529,399239,0,99,71457,0,0,2021-01-19,AR,17260,3922877,44129,1701991,61389,5624868
665,2021-01-19,AR,529,399239,0,99,71457,0,0,2021-01-19,AR,48523,3250361,11391,796417,59914,4046778
666,2021-01-19,AR,529,399239,0,99,71457,0,0,2021-01-19,AR,30432,2104442,3195,542856,33627,2647298
667,2021-01-19,AR,529,399239,0,99,71457,0,0,2021-01-19,AR,18499,1241624,5204,326633,23703,1568257
668,2021-01-19,AR,529,399239,0,99,71457,0,0,2021-01-19,AR,11225,836401,2101,119824,13326,956225
669,2021-01-19,AR,529,399239,0,99,71457,0,0,2021-01-19,AR,12560,364571,5019,86509,17579,451080
670,2021-01-19,AR,529,399239,0,99,71457,0,0,2021-01-19,AR,8183,71333,1030,37877,9213,109210
671,2021-01-19,AR,529,399239,0,99,71457,0,0,2021-01-19,AR,1146,34470,742,753,1888,35223
672,2021-01-19,AR,284,411629,0,32,73263,0,0,2021-01-19,AR,1483,5390858,3933,4563656,5416,9954514
673,2021-01-19,AR,284,411629,0,32,73263,0,0,2021-01-19,AR,8030,5196893,34233,4110909,42263,9307802
674,2021-01-19,AR,284,411629,0,32,73263,0,0,2021-01-19,AR,43175,4582278,15466,3602204,58641,8184482
675,2021-01-19,AR,284,411629,0,32,73263,0,0,2021-01-19,AR,2729,4168845,17607,2930319,20336,7099164
676,2021-01-19,AR,284,411629,0,32,73263,0,0,2021-01-19,AR,17260,3922877,44129,1701991,61389,5624868
677,2021-01-19,AR,284,411629,0,32,73263,0,0,2021-01-19,AR,48523,3250361,11391,796417,59914,4046778
678,2021-01-19,AR,284,411629,0,32,73263,0,0,2021-01-19,AR,30432,2104442,3195,542856,33627,2647298
679,2021-01-19,AR,284,411629,0,32,73263,0,0,2021-01-19,AR,18499,1241624,5204,326633,23703,1568257
680,2021-01-19,AR,284,411629,0,32,73263,0,0,2021-01-19,AR,11225,836401,2101,119824,13326,956225
681,2021-01-19,AR,284,411629,0,32,73263,0,0,2021-01-19,AR,12560,364571,5019,86509,17579,451080
682,2021-01-19,AR,284,411629,0,32,73263,0,0,2021-01-19,AR,8183,71333,1030,37877,9213,109210
683,2021-01-19,AR,284,411629,0,32,73263,0,0,2021-01-19,AR,1146,34470,742,753,1888,35223
684,2021-01-19,AR,270,419625,0,25,74214,0,0,2021-01-19,AR,1483,5390858,3933,4563656,5416,9954514
685,2021-01-19,AR,270,419625,0,25,74214,0,0,2021-01-19,AR,8030,5196893,34233,4110909,42263,9307802
686,2021-01-19,AR,270,419625,0,25,74214,0,0,2021-01-19,AR,43175,4582278,15466,3602204,58641,8184482
687,2021-01-19,AR,270,419625,0,25,74214,0,0,2021-01-19,AR,2729,4168845,17607,2930319,20336,7099164
688,2021-01-19,AR,270,419625,0,25,74214,0,0,2021-01-19,AR,17260,3922877,44129,1701991,61389,5624868
689,2021-01-19,AR,270,419625,0,25,74214,0,0,2021-01-19,AR,48523,3250361,11391,796417,59914,4046778
690,2021-01-19,AR,270,419625,0,25,74214,0,0,2021-01-19,AR,30432,2104442,3195,542856,33627,2647298
691,2021-01-19,AR,270,419625,0,25,74214,0,0,2021-01-19,AR,18499,1241624,5204,326633,23703,1568257
692,2021-01-19,AR,270,419625,0,25,74214,0,0,2021-01-19,AR,11225,836401,2101,119824,13326,956225
693,2021-01-19,AR,270,419625,0,25,74214,0,0,2021-01-19,AR,12560,364571,5019,86509,17579,451080
694,2021-01-19,AR,270,419625,0,25,74214,0,0,2021-01-19,AR,8183,71333,1030,37877,9213,109210
695,2021-01-19,AR,270,419625,0,25,74214,0,0,2021-01-19,AR,1146,34470,742,753,1888,35223
696,2021-01-19,AR,176,426998,0,27,75101,0,0,2021-01-19,AR,1483,5390858,3933,4563656,5416,9954514
697,2021-01-19,AR,176,426998,0,27,75101,0,0,2021-01-19,AR,8030,5196893,34233,4110909,42263,9307802
698,2021-01-19,AR,176,426998,0,27,75101,0,0,2021-01-19,AR,43175,4582278,15466,3602204,58641,8184482
699,2021-01-19,AR,176,426998,0,27,75101,0,0,2021-01-19,AR,2729,4168845,17607,2930319,20336,7099164
700,2021-01-19,AR,176,426998,0,27,75101,0,0,2021-01-19,AR,17260,3922877,44129,1701991,61389,5624868
701,2021-01-19,AR,176,426998,0,27,75101,0,0,2021-01-19,AR,48523,3250361,11391,796417,59914,4046778
702,2021-01-19,AR,176,426998,0,27,75101,0,0,2021-01-19,AR,30432,2104442,3195,542856,33627,2647298
703,2021-01-19,AR,176,426998,0,27,75101,0,0,2021-01-19,AR,18499,1241624,5204,326633,23703,1568257
704,2021-01-19,AR,176,426998,0,27,75101,0,0,2021-01-19,AR,11225,836401,2101,119824,13326,956225
705,2021-01-19,AR,176,426998,0,27,75101,0,0,2021-01-19,AR,12560,364571,5019,86509,17579,451080
706,2021-01-19,AR,176,426998,0,27,75101,0,0,2021-01-19,AR,8183,71333,1030,37877,9213,109210
707,2021-01-19,AR,176,426998,0,27,75101,0,0,2021-01-19,AR,1146,34470,742,753,1888,35223
708,2021-01-19,AR,191,433477,0,30,76035,0,0,2021-01-19,AR,1483,5390858,3933,4563656,5416,9954514
709,2021-01-19,AR,191,433477,0,30,76035,0,0,2021-01-19,AR,8030,5196893,34233,4110909,42263,9307802
710,2021-01-19,AR,191,433477,0,30,76035,0,0,2021-01-19,AR,43175,4582278,15466,3602204,58641,8184482
711,2021-01-19,AR,191,433477,0,30,76035,0,0,2021-01-19,AR,2729,4168845,17607,2930319,20336,7099164
712,2021-01-19,AR,191,433477,0,30,76035,0,0,2021-01-19,AR,17260,3922877,44129,1701991,61389,5624868
713,2021-01-19,AR,191,433477,0,30,76035,0,0,2021-01-19,AR,48523,3250361,11391,796417,59914,4046778
714,2021-01-19,AR,191,433477,0,30,76035,0,0,2021-01-19,AR,30432,2104442,3195,542856,33627,2647298
715,2021-01-19,AR,191,433477,0,30,76035,0,0,2021-01-19,AR,18499,1241624,5204,326633,23703,1568257
716,2021-01-19,AR,191,433477,0,30,76035,0,0,2021-01-19,AR,11225,836401,2101,119824,13326,956225
717,2021-01-19,AR,191,433477,0,30,76035,0,0,2021-01-19,AR,12560,364571,5019,86509,17579,451080
718,2021-01-19,AR,191,433477,0,30,76035,0,0,2021-01-19,AR,8183,71333,1030,37877,9213,109210
719,2021-01-19,AR,191,433477,0,30,76035,0,0,2021-01-19,AR,1146,34470,742,753,1888,35223
720,2021-01-24,AR,394,247022,0,89,39849,0,0,2021-01-24,AR,303,5417716,541,4620209,844,10037925
721,2021-01-24,AR,394,247022,0,89,39849,0,0,2021-01-24,AR,9655,5227778,25720,4187724,35375,9415502
722,2021-01-24,AR,394,247022,0,89,39849,0,0,2021-01-24,AR,16637,4752505,3302,3662033,19939,8414538
723,2021-01-24,AR,394,247022,0,89,39849,0,0,2021-01-24,AR,10093,4223779,26751,3097792,36844,7321571
724,2021-01-24,AR,394,247022,0,89,39849,0,0,2021-01-24,AR,13492,3983240,51426,1889563,64918,5872803
725,2021-01-24,AR,394,247022,0,89,39849,0,0,2021-01-24,AR,27249,3447729,6502,868664,33751,4316393
726,2021-01-24,AR,394,247022,0,89,39849,0,0,2021-01-24,AR,37587,2249453,4525,561660,42112,2811113
727,2021-01-24,AR,394,247022,0,89,39849,0,0,2021-01-24,AR,10027,1296619,3073,357519,13100,1654138
728,2021-01-24,AR,394,247022,0,89,39849,0,0,2021-01-24,AR,12736,936219,176,127614,12912,1063833
729,2021-01-24,AR,394,247022,0,89,39849,0,0,2021-01-24,AR,5478,402059,196,92315,5674,494374
730,2021-01-24,AR,394,247022,0,89,39849,0,0,2021-01-24,AR,12463,111804,848,39681,13311,151485
731,2021-01-24,AR,394,247022,0,89,39849,0,0,2021-01-24,AR,11,36913,30,4942,41,41855
732,2021-01-24,AR,473,261461,0,95,42746,0,0,2021-01-24,AR,303,5417716,541,4620209,844,10037925
733,2021-01-24,AR,473,261461,0,95,42746,0,0,2021-01-24,AR,9655,5227778,25720,4187724,35375,9415502
734,2021-01-24,AR,473,261461,0,95,42746,0,0,2021-01-24,AR,16637,4752505,3302,3662033,19939,8414538
735,2021-01-24,AR,473,261461,0,95,42746,0,0,2021-01-24,AR,10093,4223779,26751,3097792,36844,7321571
736,2021-01-24,AR,473,261461,0,95,42746,0,0,2021-01-24,AR,13492,3983240,51426,1889563,64918,5872803
737,2021-01-24,AR,473,261461,0,95,42746,0,0,2021-01-24,AR,27249,3447729,6502,868664,33751,4316393
738,2021-01-24,AR,473,261461,0,95,42746,0,0,2021-01-24,AR,37587,2249453,4525,561660,42112,2811113
739,2021-01-24,AR,473,261461,0,95,42746,0,0,2021-01-24,AR,10027,1296619,3073,357519,13100,1654138
740,2021-01-24,AR,473,261461,0,95,42746,0,0,2021-01-24,AR,12736,936219,176,127614,12912,1063833
741,2021-01-24,AR,473,261461,0,95,42746,0,0,2021-01-24,AR,5478,402059,196,92315,5674,494374
742,2021-01-24,AR,473,261461,0,95,42746,0,0,2021-01-24,AR,12463,111804,848,39681,13311,151485
743,2021-01-24,AR,473,261461,0,95,42746,0,0,2021-01-24,AR,11,36913,30,4942,41,41855
744,2021-01-24,AR,441,274478,0,96,45220,0,0,2021-01-24,AR,303,5417716,541,4620209,844,10037925
745,2021-01-24,AR,441,274478,0,96,45220,0,0,2021-01-24,AR,9655,5227778,25720,4187724,35375,9415502
746,2021-01-24,AR,441,274478,0,96,45220,0,0,2021-01-24,AR,16637,4752505,3302,3662033,19939,8414538
747,2021-01-24,AR,441,274478,0,96,45220,0,0,2021-01-24,AR,10093,4223779,26751,3097792,36844,7321571
748,2021-01-24,AR,441,274478,0,96,45220,0,0,2021-01-24,AR,13492,3983240,51426,1889563,64918,5872803
749,2021-01-24,AR,441,274478,0,96,45220,0,0,2021-01-24,AR,27249,3447729,6502,868664,33751,4316393
750,2021-01-24,AR,441,274478,0,96,45220,0,0,2021-01-24,AR,37587,2249453,4525,561660,42112,2811113
751,2021-01-24,AR,441,274478,0,96,45220,0,0,2021-01-24,AR,10027,1296619,3073,357519,13100,1654138
752,2021-01-24,AR,441,274478,0,96,45220,0,0,2021-01-24,AR,12736,936219,176,127614,12912,1063833
753,2021-01-24,AR,441,274478,0,96,45220,0,0,2021-01-24,AR,5478,402059,196,92315,5674,494374
754,2021-01-24,AR,441,274478,0,96,45220,0,0,2021-01-24,AR,12463,111804,848,39681,13311,151485
755,2021-01-24,AR,441,274478,0,96,45220,0,0,2021-01-24,AR,11,36913,30,4942,41,41855
756,2021-01-24,AR,825,298257,0,178,50123,0,0,2021-01-24,AR,303,5417716,541,4620209,844,10037925
757,2021-01-24,AR,825,298257,0,178,50123,0,0,2021-01-24,AR,9655,5227778,25720,4187724,35375,9415502
758,2021-01-24,AR,825,298257,0,178,50123,0,0,2021-01-24,AR,16637,4752505,3302,3662033,19939,8414538
759,2021-01-24,AR,825,298257,0,178,50123,0,0,2021-01-24,AR,10093,4223779,26751,3097792,36844,7321571
760,2021-01-24,AR,825,298257,0,178,50123,0,0,2021-01-24,AR,13492,3983240,51426,1889563,64918,5872803
761,2021-01-24,AR,825,298257,0,178,50123,0,0,2021-01-24,AR,27249,3447729,6502,868664,33751,4316393
762,2021-01-24,AR,825,298257,0,178,50123,0,0,2021-01-24,AR,37587,2249453,4525,561660,42112,2811113
763,2021-01-24,AR,825,298257,0,178,50123,0,0,2021-01-24,AR,10027,1296619,3073,357519,13100,1654138
764,2021-01-24,AR,825,298257,0,178,50123,0,0,2021-01-24,AR,12736,936219,176,127614,12912,1063833
765,2021-01-24,AR,825,298257,0,178,50123,0,0,2021-01-24,AR,5478,402059,196,92315,5674,494374
766,2021-01-24,AR,825,298257,0,178,50123,0,0,2021-01-24,AR,12463,111804,848,39681,13311,151485
767,2021-01-24,AR,825,298257,0,178,50123,0,0,2021-01-24,AR,11,36913,30,4942,41,41855
768,2021-01-24,AR,1112,327636,0,246,56701,0,0,2021-01-24,AR,303,5417716,541,4620209,844,10037925
769,2021-01-24,AR,1112,327636,0,246,56701,0,0,2021-01-24,AR,9655,5227778,25720,4187724,35375,9415502
770,2021-01-24,AR,1112,327636,0,246,56701,0,0,2021-01-24,AR,16637,4752505,3302,3662033,19939,8414538
771,2021-01-24,AR,1112,327636,0,246,56701,0,0,2021-01-24,AR,10093,4223779,26751,3097792,36844,7321571
772,2021-01-24,AR,1112,327636,0,246,56701,0,0,2021-01-24,AR,13492,3983240,51426,1889563,64918,5872803
773,2021-01-24,AR,1112,327636,0,246,56701,0,0,2021-01-24,AR,27249,3447729,6502,868664,33751,4316393
774,2021-01-24,AR,1112,327636,0,246,56701,0,0,2021-01-24,AR,37587,2249453,4525,561660,42112,2811113
775,2021-01-24,AR,1112,327636,0,246,56701,0,0,2021-01-24,AR,10027,1296619,3073,357519,13100,1654138
776,2021-01-24,AR,1112,327636,0,246,56701,0,0,2021-01-24,AR,12736,936219,176,127614,12912,1063833
777,2021-01-24,AR,1112,327636,0,246,56701,0,0,2021-01-24,AR,5478,402059,196,92315,5674,494374
778,2021-01-24,AR,1112,327636,0,246,56701,0,0,2021-01-24,AR,12463,111804,848,39681,13311,151485
779,2021-01-24,AR,1112,327636,0,246,56701,0,0,2021-01-24,AR,11,36913,30,4942,41,41855
780,2021-01-24,AR,911,360672,0,179,64015,0,0,2021-01-24,AR,303,5417716,541,4620209,844,10037925
781,2021-01-24,AR,911,360672,0,179,64015,0,0,2021-01-24,AR,9655,5227778,25720,4187724,35375,9415502
782,2021-01-24,AR,911,360672,0,179,64015,0,0,2021-01-24,AR,16637,4752505,3302,3662033,19939,8414538
783,2021-01-24,AR,911,360672,0,179,64015,0,0,2021-01-24,AR,10093,4223779,26751,3097792,36844,7321571
784,2021-01-24,AR,911,360672,0,179,64015,0,0,2021-01-24,AR,13492,3983240,51426,1889563,64918,5872803
785,2021-01-24,AR,911,360672,0,179,64015,0,0,2021-01-24,AR,27249,3447729,6502,868664,33751,4316393
786,2021-01-24,AR,911,360672,0,179,64015,0,0,2021-01-24,AR,37587,2249453,4525,561660,42112,2811113
787,2021-01-24,AR,911,360672,0,179,64015,0,0,2021-01-24,AR,10027,1296619,3073,357519,13100,1654138
788,2021-01-24,AR,911,360672,0,179,64015,0,0,2021-01-24,AR,12736,936219,176,127614,12912,1063833
789,2021-01-24,AR,911,360672,0,179,64015,0,0,2021-01-24,AR,5478,402059,196,92315,5674,494374
790,2021-01-24,AR,911,360672,0,179,64015,0,0,2021-01-24,AR,12463,111804,848,39681,13311,151485
791,2021-01-24,AR,911,360672,0,179,64015,0,0,2021-01-24,AR,11,36913,30,4942,41,41855
792,2021-01-24,AR,603,383951,0,101,68636,0,0,2021-01-24,AR,303,5417716,541,4620209,844,10037925
793,2021-01-24,AR,603,383951,0,101,68636,0,0,2021-01-24,AR,9655,5227778,25720,4187724,35375,9415502
794,2021-01-24,AR,603,383951,0,101,68636,0,0,2021-01-24,AR,16637,4752505,3302,3662033,19939,8414538
795,2021-01-24,AR,603,383951,0,101,68636,0,0,2021-01-24,AR,10093,4223779,26751,3097792,36844,7321571
796,2021-01-24,AR,603,383951,0,101,68636,0,0,2021-01-24,AR,13492,3983240,51426,1889563,64918,5872803
797,2021-01-24,AR,603,383951,0,101,68636,0,0,2021-01-24,AR,27249,3447729,6502,868664,33751,4316393
798,2021-01-24,AR,603,383951,0,101,68636,0,0,2021-01-24,AR,37587,2249453,4525,561660,42112,2811113
799,2021-01-24,AR,603,383951,0,101,68636,0,0,2021-01-24,AR,10027,1296619,3073,357519,13100,1654138
800,2021-01-24,AR,603,383951,0,101,68636,0,0,2021-01-24,AR,12736,936219,176,127614,12912,1063833
801,2021-01-24,AR,603,383951,0,101,68636,0,0,2021-01-24,AR,5478,402059,196,92315,5674,494374
802,2021-01-24,AR,603,383951,0,101,68636,0,0,2021-01-24,AR,12463,111804,848,39681,13311,151485
803,2021-01-24,AR,603,383951,0,101,68636,0,0,2021-01-24,AR,11,36913,30,4942,41,41855
804,2021-01-24,AR,539,401618,0,87,71830,0,0,2021-01-24,AR,303,5417716,541,4620209,844,10037925
805,2021-01-24,AR,539,401618,0,87,71830,0,0,2021-01-24,AR,9655,5227778,25720,4187724,35375,9415502
806,2021-01-24,AR,539,401618,0,87,71830,0,0,2021-01-24,AR,16637,4752505,3302,3662033,19939,8414538
807,2021-01-24,AR,539,401618,0,87,71830,0,0,2021-01-24,AR,10093,4223779,26751,3097792,36844,7321571
808,2021-01-24,AR,539,401618,0,87,71830,0,0,2021-01-24,AR,13492,3983240,51426,1889563,64918,5872803
809,2021-01-24,AR,539,401618,0,87,71830,0,0,2021-01-24,AR,27249,3447729,6502,868664,33751,4316393
810,2021-01-24,AR,539,401618,0,87,71830,0,0,2021-01-24,AR,37587,2249453,4525,561660,42112,2811113
811,2021-01-24,AR,539,401618,0,87,71830,0,0,2021-01-24,AR,10027,1296619,3073,357519,13100,1654138
812,2021-01-24,AR,539,401618,0,87,71830,0,0,2021-01-24,AR,12736,936219,176,127614,12912,1063833
813,2021-01-24,AR,539,401618,0,87,71830,0,0,2021-01-24,AR,5478,402059,196,92315,5674,494374
814,2021-01-24,AR,539,401618,0,87,71830,0,0,2021-01-24,AR,12463,111804,848,39681,13311,151485
815,2021-01-24,AR,539,401618,0,87,71830,0,0,2021-01-24,AR,11,36913,30,4942,41,41855
816,2021-01-24,AR,227,413199,0,25,73444,0,0,2021-01-24,AR,303,5417716,541,4620209,844,10037925
817,2021-01-24,AR,227,413199,0,25,73444,0,0,2021-01-24,AR,9655,5227778,25720,4187724,35375,9415502
818,2021-01-24,AR,227,413199,0,25,73444,0,0,2021-01-24,AR,16637,4752505,3302,3662033,19939,8414538
819,2021-01-24,AR,227,413199,0,25,73444,0,0,2021-01-24,AR,10093,4223779,26751,3097792,36844,7321571
820,2021-01-24,AR,227,413199,0,25,73444,0,0,2021-01-24,AR,13492,3983240,51426,1889563,64918,5872803
821,2021-01-24,AR,227,413199,0,25,73444,0,0,2021-01-24,AR,27249,3447729,6502,868664,33751,4316393
822,2021-01-24,AR,227,413199,0,25,73444,0,0,2021-01-24,AR,37587,2249453,4525,561660,42112,2811113
823,2021-01-24,AR,227,413199,0,25,73444,0,0,2021-01-24,AR,10027,1296619,3073,357519,13100,1654138
824,2021-01-24,AR,227,413199,0,25,73444,0,0,2021-01-24,AR,12736,936219,176,127614,12912,1063833
825,2021-01-24,AR,227,413199,0,25,73444,0,0,2021-01-24,AR,5478,402059,196,92315,5674,494374
826,2021-01-24,AR,227,413199,0,25,73444,0,0,2021-01-24,AR,12463,111804,848,39681,13311,151485
827,2021-01-24,AR,227,413199,0,25,73444,0,0,2021-01-24,AR,11,36913,30,4942,41,41855
828,2021-01-24,AR,199,420826,0,20,74361,0,0,2021-01-24,AR,303,5417716,541,4620209,844,10037925
829,2021-01-24,AR,199,420826,0,20,74361,0,0,2021-01-24,AR,9655,5227778,25720,4187724,35375,9415502
830,2021-01-24,AR,199,420826,0,20,74361,0,0,2021-01-24,AR,16637,4752505,3302,3662033,19939,8414538
831,2021-01-24,AR,199,420826,0,20,74361,0,0,2021-01-24,AR,10093,4223779,26751,3097792,36844,7321571
832,2021-01-24,AR,199,420826,0,20,74361,0,0,2021-01-24,AR,13492,3983240,51426,1889563,64918,5872803
833,2021-01-24,AR,199,420826,0,20,74361,0,0,2021-01-24,AR,27249,3447729,6502,868664,33751,4316393
834,2021-01-24,AR,199,420826,0,20,74361,0,0,2021-01-24,AR,37587,2249453,4525,561660,42112,2811113
835,2021-01-24,AR,199,420826,0,20,74361,0,0,2021-01-24,AR,10027,1296619,3073,357519,13100,1654138
836,2021-01-24,AR,199,420826,0,20,74361,0,0,2021-01-24,AR,12736,936219,176,127614,12912,1063833
837,2021-01-24,AR,199,420826,0,20,74361,0,0,2021-01-24,AR,5478,402059,196,92315,5674,494374
838,2021-01-24,AR,199,420826,0,20,74361,0,0,2021-01-24,AR,12463,111804,848,39681,13311,151485
839,2021-01-24,AR,199,420826,0,20,74361,0,0,2021-01-24,AR,11,36913,30,4942,41,41855
840,2021-01-24,AR,244,427977,0,30,75252,0,0,2021-01-24,AR,303,5417716,541,4620209,844,10037925
841,2021-01-24,AR,244,427977,0,30,75252,0,0,2021-01-24,AR,9655,5227778,25720,4187724,35375,9415502
842,2021-01-24,AR,244,427977,0,30,75252,0,0,2021-01-24,AR,16637,4752505,3302,3662033,19939,8414538
843,2021-01-24,AR,244,427977,0,30,75252,0,0,2021-01-24,AR,10093,4223779,26751,3097792,36844,7321571
844,2021-01-24,AR,244,427977,0,30,75252,0,0,2021-01-24,AR,13492,3983240,51426,1889563,64918,5872803
845,2021-01-24,AR,244,427977,0,30,75252,0,0,2021-01-24,AR,27249,3447729,6502,868664,33751,4316393
846,2021-01-24,AR,244,427977,0,30,75252,0,0,2021-01-24,AR,37587,2249453,4525,561660,42112,2811113
847,2021-01-24,AR,244,427977,0,30,75252,0,0,2021-01-24,AR,10027,1296619,3073,357519,13100,1654138
848,2021-01-24,AR,244,427977,0,30,75252,0,0,2021-01-24,AR,12736,936219,176,127614,12912,1063833
849,2021-01-24,AR,244,427977,0,30,75252,0,0,2021-01-24,AR,5478,402059,196,92315,5674,494374
850,2021-01-24,AR,244,427977,0,30,75252,0,0,2021-01-24,AR,12463,111804,848,39681,13311,151485
851,2021-01-24,AR,244,427977,0,30,75252,0,0,2021-01-24,AR,11,36913,30,4942,41,41855
852,2021-01-24,AR,166,434644,0,29,76225,0,0,2021-01-24,AR,303,5417716,541,4620209,844,10037925
853,2021-01-24,AR,166,434644,0,29,76225,0,0,2021-01-24,AR,9655,5227778,25720,4187724,35375,9415502
854,2021-01-24,AR,166,434644,0,29,76225,0,0,2021-01-24,AR,16637,4752505,3302,3662033,19939,8414538
855,2021-01-24,AR,166,434644,0,29,76225,0,0,2021-01-24,AR,10093,4223779,26751,3097792,36844,7321571
856,2021-01-24,AR,166,434644,0,29,76225,0,0,2021-01-24,AR,13492,3983240,51426,1889563,64918,5872803
857,2021-01-24,AR,166,434644,0,29,76225,0,0,2021-01-24,AR,27249,3447729,6502,868664,33751,4316393
858,2021-01-24,AR,166,434644,0,29,76225,0,0,2021-01-24,AR,37587,2249453,4525,561660,42112,2811113
859,2021-01-24,AR,166,434644,0,29,76225,0,0,2021-01-24,AR,10027,1296619,3073,357519,13100,1654138
860,2021-01-24,AR,166,434644,0,29,76225,0,0,2021-01-24,AR,12736,936219,176,127614,12912,1063833
861,2021-01-24,AR,166,434644,0,29,76225,0,0,2021-01-24,AR,5478,402059,196,92315,5674,494374
862,2021-01-24,AR,166,434644,0,29,76225,0,0,2021-01-24,AR,12463,111804,848,39681,13311,151485
863,2021-01-24,AR,166,434644,0,29,76225,0,0,2021-01-24,AR,11,36913,30,4942,41,41855
864,2021-01-22,AR,524,246200,0,94,39660,0,0,2021-01-22,AR,7477,5412433,15555,4608821,23032,10021254
865,2021-01-22,AR,524,246200,0,94,39660,0,0,2021-01-22,AR,3532,5208144,7554,4137479,11086,9345623
866,2021-01-22,AR,524,246200,0,94,39660,0,0,2021-01-22,AR,48411,4713881,16116,3650189,64527,8364070
867,2021-01-22,AR,524,246200,0,94,39660,0,0,2021-01-22,AR,7976,4190361,38672,3051398,46648,7241759
868,2021-01-22,AR,524,246200,0,94,39660,0,0,2021-01-22,AR,3396,3951381,21031,1795903,24427,5747284
869,2021-01-22,AR,524,246200,0,94,39660,0,0,2021-01-22,AR,45089,3375087,9514,849561,54603,4224648
870,2021-01-22,AR,524,246200,0,94,39660,0,0,2021-01-22,AR,37123,2178242,5912,553012,43035,2731254
871,2021-01-22,AR,524,246200,0,94,39660,0,0,2021-01-22,AR,8493,1283612,6385,351009,14878,1634621
872,2021-01-22,AR,524,246200,0,94,39660,0,0,2021-01-22,AR,22983,898071,1857,125618,24840,1023689
873,2021-01-22,AR,524,246200,0,94,39660,0,0,2021-01-22,AR,10681,383165,1896,90334,12577,473499
874,2021-01-22,AR,524,246200,0,94,39660,0,0,2021-01-22,AR,9076,87603,243,38319,9319,125922
875,2021-01-22,AR,524,246200,0,94,39660,0,0,2021-01-22,AR,731,36737,526,4486,1257,41223
876,2021-01-22,AR,469,260527,0,83,42560,0,0,2021-01-22,AR,7477,5412433,15555,4608821,23032,10021254
877,2021-01-22,AR,469,260527,0,83,42560,0,0,2021-01-22,AR,3532,5208144,7554,4137479,11086,9345623
878,2021-01-22,AR,469,260527,0,83,42560,0,0,2021-01-22,AR,48411,4713881,16116,3650189,64527,8364070
879,2021-01-22,AR,469,260527,0,83,42560,0,0,2021-01-22,AR,7976,4190361,38672,3051398,46648,7241759
880,2021-01-22,AR,469,260527,0,83,42560,0,0,2021-01-22,AR,3396,3951381,21031,1795903,24427,5747284
881,2021-01-22,AR,469,260527,0,83,42560,0,0,2021-01-22,AR,45089,3375087,9514,849561,54603,4224648
882,2021-01-22,AR,469,260527,0,83,42560,0,0,2021-01-22,AR,37123,2178242,5912,553012,43035,2731254
883,2021-01-22,AR,469,260527,0,83,42560,0,0,2021-01-22,AR,8493,1283612,6385,351009,14878,1634621
884,2021-01-22,AR,469,260527,0,83,42560,0,0,2021-01-22,AR,22983,898071,1857,125618,24840,1023689
885,2021-01-22,AR,469,260527,0,83,42560,0,0,2021-01-22,AR,10681,383165,1896,90334,12577,473499
886,2021-01-22,AR,469,260527,0,83,42560,0,0,2021-01-22,AR,9076,87603,243,38319,9319,125922
887,2021-01-22,AR,469,260527,0,83,42560,0,0,2021-01-22,AR,731,36737,526,4486,1257,41223
888,2021-01-22,AR,537,273448,0,99,45027,0,0,2021-01-22,AR,7477,5412433,15555,4608821,23032,10021254
889,2021-01-22,AR,537,273448,0,99,45027,0,0,2021-01-22,AR,3532,5208144,7554,4137479,11086,9345623
890,2021-01-22,AR,537,273448,0,99,45027,0,0,2021-01-22,AR,48411,4713881,16116,3650189,64527,8364070
891,2021-01-22,AR,537,273448,0,99,45027,0,0,2021-01-22,AR,7976,4190361,38672,3051398,46648,7241759
892,2021-01-22,AR,537,273448,0,99,45027,0,0,2021-01-22,AR,3396,3951381,21031,1795903,24427,5747284
893,2021-01-22,AR,537,273448,0,99,45027,0,0,2021-01-22,AR,45089,3375087,9514,849561,54603,4224648
894,2021-01-22,AR,537,273448,0,99,45027,0,0,2021-01-22,AR,37123,2178242,5912,553012,43035,2731254
895,2021-01-22,AR,537,273448,0,99,45027,0,0,2021-01-22,AR,8493,1283612,6385,351009,14878,1634621
896,2021-01-22,AR,537,273448,0,99,45027,0,0,2021-01-22,AR,22983,898071,1857,125618,24840,1023689
897,2021-01-22,AR,537,273448,0,99,45027,0,0,2021-01-22,AR,10681,383165,1896,90334,12577,473499
898,2021-01-22,AR,537,273448,0,99,45027,0,0,2021-01-22,AR,9076,87603,243,38319,9319,125922
899,2021-01-22,AR,537,273448,0,99,45027,0,0,2021-01-22,AR,731,36737,526,4486,1257,41223
900,2021-01-22,AR,995,296509,0,209,49771,0,0,2021-01-22,AR,7477,5412433,15555,4608821,23032,10021254
901,2021-01-22,AR,995,296509,0,209,49771,0,0,2021-01-22,AR,3532,5208144,7554,4137479,11086,9345623
902,2021-01-22,AR,995,296509,0,209,49771,0,0,2021-01-22,AR,48411,4713881,16116,3650189,64527,8364070
903,2021-01-22,AR,995,296509,0,209,49771,0,0,2021-01-22,AR,7976,4190361,38672,3051398,46648,7241759
904,2021-01-22,AR,995,296509,0,209,49771,0,0,2021-01-22,AR,3396,3951381,21031,1795903,24427,5747284
905,2021-01-22,AR,995,296509,0,209,49771,0,0,2021-01-22,AR,45089,3375087,9514,849561,54603,4224648
906,2021-01-22,AR,995,296509,0,209,49771,0,0,2021-01-22,AR,37123,2178242,5912,553012,43035,2731254
907,2021-01-22,AR,995,296509,0,209,49771,0,0,2021-01-22,AR,8493,1283612,6385,351009,14878,1634621
908,2021-01-22,AR,995,296509,0,209,49771,0,0,2021-01-22,AR,22983,898071,1857,125618,24840,1023689
909,2021-01-22,AR,995,296509,0,209,49771,0,0,2021-01-22,AR,10681,383165,1896,90334,12577,473499
910,2021-01-22,AR,995,296509,0,209,49771,0,0,2021-01-22,AR,9076,87603,243,38319,9319,125922
911,2021-01-22,AR,995,296509,0,209,49771,0,0,2021-01-22,AR,731,36737,526,4486,1257,41223
912,2021-01-22,AR,1045,325582,0,257,56242,0,0,2021-01-22,AR,7477,5412433,15555,4608821,23032,10021254
913,2021-01-22,AR,1045,325582,0,257,56242,0,0,2021-01-22,AR,3532,5208144,7554,4137479,11086,9345623
914,2021-01-22,AR,1045,325582,0,257,56242,0,0,2021-01-22,AR,48411,4713881,16116,3650189,64527,8364070
915,2021-01-22,AR,1045,325582,0,257,56242,0,0,2021-01-22,AR,7976,4190361,38672,3051398,46648,7241759
916,2021-01-22,AR,1045,325582,0,257,56242,0,0,2021-01-22,AR,3396,3951381,21031,1795903,24427,5747284
917,2021-01-22,AR,1045,325582,0,257,56242,0,0,2021-01-22,AR,45089,3375087,9514,849561,54603,4224648
918,2021-01-22,AR,1045,325582,0,257,56242,0,0,2021-01-22,AR,37123,2178242,5912,553012,43035,2731254
919,2021-01-22,AR,1045,325582,0,257,56242,0,0,2021-01-22,AR,8493,1283612,6385,351009,14878,1634621
920,2021-01-22,AR,1045,325582,0,257,56242,0,0,2021-01-22,AR,22983,898071,1857,125618,24840,1023689
921,2021-01-22,AR,1045,325582,0,257,56242,0,0,2021-01-22,AR,10681,383165,1896,90334,12577,473499
922,2021-01-22,AR,1045,325582,0,257,56242,0,0,2021-01-22,AR,9076,87603,243,38319,9319,125922
923,2021-01-22,AR,1045,325582,0,257,56242,0,0,2021-01-22,AR,731,36737,526,4486,1257,41223
924,2021-01-22,AR,1032,358785,0,232,63625,0,0,2021-01-22,AR,7477,5412433,15555,4608821,23032,10021254
925,2021-01-22,AR,1032,358785,0,232,63625,0,0,2021-01-22,AR,3532,5208144,7554,4137479,11086,9345623
926,2021-01-22,AR,1032,358785,0,232,63625,0,0,2021-01-22,AR,48411,4713881,16116,3650189,64527,8364070
927,2021-01-22,AR,1032,358785,0,232,63625,0,0,2021-01-22,AR,7976,4190361,38672,3051398,46648,7241759
928,2021-01-22,AR,1032,358785,0,232,63625,0,0,2021-01-22,AR,3396,3951381,21031,1795903,24427,5747284
929,2021-01-22,AR,1032,358785,0,232,63625,0,0,2021-01-22,AR,45089,3375087,9514,849561,54603,4224648
930,2021-01-22,AR,1032,358785,0,232,63625,0,0,2021-01-22,AR,37123,2178242,5912,553012,43035,2731254
931,2021-01-22,AR,1032,358785,0,232,63625,0,0,2021-01-22,AR,8493,1283612,6385,351009,14878,1634621
932,2021-01-22,AR,1032,358785,0,232,63625,0,0,2021-01-22,AR,22983,898071,1857,125618,24840,1023689
933,2021-01-22,AR,1032,358785,0,232,63625,0,0,2021-01-22,AR,10681,383165,1896,90334,12577,473499
934,2021-01-22,AR,1032,358785,0,232,63625,0,0,2021-01-22,AR,9076,87603,243,38319,9319,125922
935,2021-01-22,AR,1032,358785,0,232,63625,0,0,2021-01-22,AR,731,36737,526,4486,1257,41223
936,2021-01-22,AR,726,382645,0,140,68398,0,0,2021-01-22,AR,7477,5412433,15555,4608821,23032,10021254
937,2021-01-22,AR,726,382645,0,140,68398,0,0,2021-01-22,AR,3532,5208144,7554,4137479,11086,9345623
938,2021-01-22,AR,726,382645,0,140,68398,0,0,2021-01-22,AR,48411,4713881,16116,3650189,64527,8364070
939,2021-01-22,AR,726,382645,0,140,68398,0,0,2021-01-22,AR,7976,4190361,38672,3051398,46648,7241759
940,2021-01-22,AR,726,382645,0,140,68398,0,0,2021-01-22,AR,3396,3951381,21031,1795903,24427,5747284
941,2021-01-22,AR,726,382645,0,140,68398,0,0,2021-01-22,AR,45089,3375087,9514,849561,54603,4224648
942,2021-01-22,AR,726,382645,0,140,68398,0,0,2021-01-22,AR,37123,2178242,5912,553012,43035,2731254
943,2021-01-22,AR,726,382645,0,140,68398,0,0,2021-01-22,AR,8493,1283612,6385,351009,14878,1634621
944,2021-01-22,AR,726,382645,0,140,68398,0,0,2021-01-22,AR,22983,898071,1857,125618,24840,1023689
945,2021-01-22,AR,726,382645,0,140,68398,0,0,2021-01-22,AR,10681,383165,1896,90334,12577,473499
946,2021-01-22,AR,726,382645,0,140,68398,0,0,2021-01-22,AR,9076,87603,243,38319,9319,125922
947,2021-01-22,AR,726,382645,0,140,68398,0,0,2021-01-22,AR,731,36737,526,4486,1257,41223
948,2021-01-22,AR,417,400554,0,68,71668,0,0,2021-01-22,AR,7477,5412433,15555,4608821,23032,10021254
949,2021-01-22,AR,417,400554,0,68,71668,0,0,2021-01-22,AR,3532,5208144,7554,4137479,11086,9345623
950,2021-01-22,AR,417,400554,0,68,71668,0,0,2021-01-22,AR,48411,4713881,16116,3650189,64527,8364070
951,2021-01-22,AR,417,400554,0,68,71668,0,0,2021-01-22,AR,7976,4190361,38672,3051398,46648,7241759
952,2021-01-22,AR,417,400554,0,68,71668,0,0,2021-01-22,AR,3396,3951381,21031,1795903,24427,5747284
953,2021-01-22,AR,417,400554,0,68,71668,0,0,2021-01-22,AR,45089,3375087,9514,849561,54603,4224648
954,2021-01-22,AR,417,400554,0,68,71668,0,0,2021-01-22,AR,37123,2178242,5912,553012,43035,2731254
955,2021-01-22,AR,417,400554,0,68,71668,0,0,2021-01-22,AR,8493,1283612,6385,351009,14878,1634621
956,2021-01-22,AR,417,400554,0,68,71668,0,0,2021-01-22,AR,22983,898071,1857,125618,24840,1023689
957,2021-01-22,AR,417,400554,0,68,71668,0,0,2021-01-22,AR,10681,383165,1896,90334,12577,473499
958,2021-01-22,AR,417,400554,0,68,71668,0,0,2021-01-22,AR,9076,87603,243,38319,9319,125922
959,2021-01-22,AR,417,400554,0,68,71668,0,0,2021-01-22,AR,731,36737,526,4486,1257,41223
960,2021-01-22,AR,303,412655,0,36,73379,0,0,2021-01-22,AR,7477,5412433,15555,4608821,23032,10021254
961,2021-01-22,AR,303,412655,0,36,73379,0,0,2021-01-22,AR,3532,5208144,7554,4137479,11086,9345623
962,2021-01-22,AR,303,412655,0,36,73379,0,0,2021-01-22,AR,48411,4713881,16116,3650189,64527,8364070
963,2021-01-22,AR,303,412655,0,36,73379,0,0,2021-01-22,AR,7976,4190361,38672,3051398,46648,7241759
964,2021-01-22,AR,303,412655,0,36,73379,0,0,2021-01-22,AR,3396,3951381,21031,1795903,24427,5747284
965,2021-01-22,AR,303,412655,0,36,73379,0,0,2021-01-22,AR,45089,3375087,9514,849561,54603,4224648
966,2021-01-22,AR,303,412655,0,36,73379,0,0,2021-01-22,AR,37123,2178242,5912,553012,43035,2731254
967,2021-01-22,AR,303,412655,0,36,73379,0,0,2021-01-22,AR,8493,1283612,6385,351009,14878,1634621
968,2021-01-22,AR,303,412655,0,36,73379,0,0,2021-01-22,AR,22983,898071,1857,125618,24840,1023689
969,2021-01-22,AR,303,412655,0,36,73379,0,0,2021-01-22,AR,10681,383165,1896,90334,12577,473499
970,2021-01-22,AR,303,412655,0,36,73379,0,0,2021-01-22,AR,9076,87603,243,38319,9319,125922
971,2021-01-22,AR,303,412655,0,36,73379,0,0,2021-01-22,AR,731,36737,526,4486,1257,41223
972,2021-01-22,AR,240,420431,0,31,74310,0,0,2021-01-22,AR,7477,5412433,15555,4608821,23032,10021254
973,2021-01-22,AR,240,420431,0,31,74310,0,0,2021-01-22,AR,3532,5208144,7554,4137479,11086,9345623
974,2021-01-22,AR,240,420431,0,31,74310,0,0,2021-01-22,AR,48411,4713881,16116,3650189,64527,8364070
975,2021-01-22,AR,240,420431,0,31,74310,0,0,2021-01-22,AR,7976,4190361,38672,3051398,46648,7241759
976,2021-01-22,AR,240,420431,0,31,74310,0,0,2021-01-22,AR,3396,3951381,21031,1795903,24427,5747284
977,2021-01-22,AR,240,420431,0,31,74310,0,0,2021-01-22,AR,45089,3375087,9514,849561,54603,4224648
978,2021-01-22,AR,240,420431,0,31,74310,0,0,2021-01-22,AR,37123,2178242,5912,553012,43035,2731254
979,2021-01-22,AR,240,420431,0,31,74310,0,0,2021-01-22,AR,8493,1283612,6385,351009,14878,1634621
980,2021-01-22,AR,240,420431,0,31,74310,0,0,2021-01-22,AR,22983,898071,1857,125618,24840,1023689
981,2021-01-22,AR,240,420431,0,31,74310,0,0,2021-01-22,AR,10681,383165,1896,90334,12577,473499
982,2021-01-22,AR,240,420431,0,31,74310,0,0,2021-01-22,AR,9076,87603,243,38319,9319,125922
983,2021-01-22,AR,240,420431,0,31,74310,0,0,2021-01-22,AR,731,36737,526,4486,1257,41223
984,2021-01-22,AR,197,427502,0,35,75178,0,0,2021-01-22,AR,7477,5412433,15555,4608821,23032,10021254
985,2021-01-22,AR,197,427502,0,35,75178,0,0,2021-01-22,AR,3532,5208144,7554,4137479,11086,9345623
986,2021-01-22,AR,197,427502,0,35,75178,0,0,2021-01-22,AR,48411,4713881,16116,3650189,64527,8364070
987,2021-01-22,AR,197,427502,0,35,75178,0,0,2021-01-22,AR,7976,4190361,38672,3051398,46648,7241759
988,2021-01-22,AR,197,427502,0,35,75178,0,0,2021-01-22,AR,3396,3951381,21031,1795903,24427,5747284
989,2021-01-22,AR,197,427502,0,35,75178,0,0,2021-01-22,AR,45089,3375087,9514,849561,54603,4224648
990,2021-01-22,AR,197,427502,0,35,75178,0,0,2021-01-22,AR,37123,2178242,5912,553012,43035,2731254
991,2021-01-22,AR,197,427502,0,35,75178,0,0,2021-01-22,AR,8493,1283612,6385,351009,14878,1634621
992,2021-01-22,AR,197,427502,0,35,75178,0,0,2021-01-22,AR,22983,898071,1857,125618,24840,1023689
993,2021-01-22,AR,197,427502,0,35,75178,0,0,2021-01-22,AR,10681,383165,1896,90334,12577,473499
994,2021-01-22,AR,197,427502,0,35,75178,0,0,2021-01-22,AR,9076,87603,243,38319,9319,125922
995,2021-01-22,AR,197,427502,0,35,75178,0,0,2021-01-22,AR,731,36737,526,4486,1257,41223
996,2021-01-22,AR,233,434253,0,41,76161,0,0,2021-01-22,AR,7477,5412433,15555,4608821,23032,10021254
997,2021-01-22,AR,233,434253,0,41,76161,0,0,2021-01-22,AR,3532,5208144,7554,4137479,11086,9345623
998,2021-01-22,AR,233,434253,0,41,76161,0,0,2021-01-22,AR,48411,4713881,16116,3650189,64527,8364070
999,2021-01-22,AR,233,434253,0,41,76161,0,0,2021-01-22,AR,7976,4190361,38672,3051398,46648,7241759
1000,2021-01-22,AR,233,434253,0,41,76161,0,0,2021-01-22,AR,3396,3951381,21031,1795903,24427,5747284
1001,2021-01-22,AR,233,434253,0,41,76161,0,0,2021-01-22,AR,45089,3375087,9514,849561,54603,4224648
1002,2021-01-22,AR,233,434253,0,41,76161,0,0,2021-01-22,AR,37123,2178242,5912,553012,43035,2731254
1003,2021-01-22,AR,233,434253,0,41,76161,0,0,2021-01-22,AR,8493,1283612,6385,351009,14878,1634621
1004,2021-01-22,AR,233,434253,0,41,76161,0,0,2021-01-22,AR,22983,898071,1857,125618,24840,1023689
1005,2021-01-22,AR,233,434253,0,41,76161,0,0,2021-01-22,AR,10681,383165,1896,90334,12577,473499
1006,2021-01-22,AR,233,434253,0,41,76161,0,0,2021-01-22,AR,9076,87603,243,38319,9319,125922
1007,2021-01-22,AR,233,434253,0,41,76161,0,0,2021-01-22,AR,731,36737,526,4486,1257,41223
1008,2021-01-23,AR,428,246628,0,100,39760,0,0,2021-01-23,AR,4980,5417413,10847,4619668,15827,10037081
1009,2021-01-23,AR,428,246628,0,100,39760,0,0,2021-01-23,AR,9979,5218123,24525,4162004,34504,9380127
1010,2021-01-23,AR,428,246628,0,100,39760,0,0,2021-01-23,AR,21987,4735868,8542,3658731,30529,8394599
1011,2021-01-23,AR,428,246628,0,100,39760,0,0,2021-01-23,AR,23325,4213686,19643,3071041,42968,7284727
1012,2021-01-23,AR,428,246628,0,100,39760,0,0,2021-01-23,AR,18367,3969748,42234,1838137,60601,5807885
1013,2021-01-23,AR,428,246628,0,100,39760,0,0,2021-01-23,AR,45393,3420480,12601,862162,57994,4282642
1014,2021-01-23,AR,428,246628,0,100,39760,0,0,2021-01-23,AR,33624,2211866,4123,557135,37747,2769001
1015,2021-01-23,AR,428,246628,0,100,39760,0,0,2021-01-23,AR,2980,1286592,3437,354446,6417,1641038
1016,2021-01-23,AR,428,246628,0,100,39760,0,0,2021-01-23,AR,25412,923483,1820,127438,27232,1050921
1017,2021-01-23,AR,428,246628,0,100,39760,0,0,2021-01-23,AR,13416,396581,1785,92119,15201,488700
1018,2021-01-23,AR,428,246628,0,100,39760,0,0,2021-01-23,AR,11738,99341,514,38833,12252,138174
1019,2021-01-23,AR,428,246628,0,100,39760,0,0,2021-01-23,AR,165,36902,426,4912,591,41814
1020,2021-01-23,AR,461,260988,0,91,42651,0,0,2021-01-23,AR,4980,5417413,10847,4619668,15827,10037081
1021,2021-01-23,AR,461,260988,0,91,42651,0,0,2021-01-23,AR,9979,5218123,24525,4162004,34504,9380127
1022,2021-01-23,AR,461,260988,0,91,42651,0,0,2021-01-23,AR,21987,4735868,8542,3658731,30529,8394599
1023,2021-01-23,AR,461,260988,0,91,42651,0,0,2021-01-23,AR,23325,4213686,19643,3071041,42968,7284727
1024,2021-01-23,AR,461,260988,0,91,42651,0,0,2021-01-23,AR,18367,3969748,42234,1838137,60601,5807885
1025,2021-01-23,AR,461,260988,0,91,42651,0,0,2021-01-23,AR,45393,3420480,12601,862162,57994,4282642
1026,2021-01-23,AR,461,260988,0,91,42651,0,0,2021-01-23,AR,33624,2211866,4123,557135,37747,2769001
1027,2021-01-23,AR,461,260988,0,91,42651,0,0,2021-01-23,AR,2980,1286592,3437,354446,6417,1641038
1028,2021-01-23,AR,461,260988,0,91,42651,0,0,2021-01-23,AR,25412,923483,1820,127438,27232,1050921
1029,2021-01-23,AR,461,260988,0,91,42651,0,0,2021-01-23,AR,13416,396581,1785,92119,15201,488700
1030,2021-01-23,AR,461,260988,0,91,42651,0,0,2021-01-23,AR,11738,99341,514,38833,12252,138174
1031,2021-01-23,AR,461,260988,0,91,42651,0,0,2021-01-23,AR,165,36902,426,4912,591,41814
1032,2021-01-23,AR,589,274037,0,97,45124,0,0,2021-01-23,AR,4980,5417413,10847,4619668,15827,10037081
1033,2021-01-23,AR,589,274037,0,97,45124,0,0,2021-01-23,AR,9979,5218123,24525,4162004,34504,9380127
1034,2021-01-23,AR,589,274037,0,97,45124,0,0,2021-01-23,AR,21987,4735868,8542,3658731,30529,8394599
1035,2021-01-23,AR,589,274037,0,97,45124,0,0,2021-01-23,AR,23325,4213686,19643,3071041,42968,7284727
1036,2021-01-23,AR,589,274037,0,97,45124,0,0,2021-01-23,AR,18367,3969748,42234,1838137,60601,5807885
1037,2021-01-23,AR,589,274037,0,97,45124,0,0,2021-01-23,AR,45393,3420480,12601,862162,57994,4282642
1038,2021-01-23,AR,589,274037,0,97,45124,0,0,2021-01-23,AR,33624,2211866,4123,557135,37747,2769001
1039,2021-01-23,AR,589,274037,0,97,45124,0,0,2021-01-23,AR,2980,1286592,3437,354446,6417,1641038
1040,2021-01-23,AR,589,274037,0,97,45124,0,0,2021-01-23,AR,25412,923483,1820,127438,27232,1050921
1041,2021-01-23,AR,589,274037,0,97,45124,0,0,2021-01-23,AR,13416,396581,1785,92119,15201,488700
1042,2021-01-23,AR,589,274037,0,97,45124,0,0,2021-01-23,AR,11738,99341,514,38833,12252,138174
1043,2021-01-23,AR,589,274037,0,97,45124,0,0,2021-01-23,AR,165,36902,426,4912,591,41814
1044,2021-01-23,AR,923,297432,0,174,49945,0,0,2021-01-23,AR,4980,5417413,10847,4619668,15827,10037081
1045,2021-01-23,AR,923,297432,0,174,49945,0,0,2021-01-23,AR,9979,5218123,24525,4162004,34504,9380127
1046,2021-01-23,AR,923,297432,0,174,49945,0,0,2021-01-23,AR,21987,4735868,8542,3658731,30529,8394599
1047,2021-01-23,AR,923,297432,0,174,49945,0,0,2021-01-23,AR,23325,4213686,19643,3071041,42968,7284727
1048,2021-01-23,AR,923,297432,0,174,49945,0,0,2021-01-23,AR,18367,3969748,42234,1838137,60601,5807885
1049,2021-01-23,AR,923,297432,0,174,49945,0,0,2021-01-23,AR,45393,3420480,12601,862162,57994,4282642
1050,2021-01-23,AR,923,297432,0,174,49945,0,0,2021-01-23,AR,33624,2211866,4123,557135,37747,2769001
1051,2021-01-23,AR,923,297432,0,174,49945,0,0,2021-01-23,AR,2980,1286592,3437,354446,6417,1641038
1052,2021-01-23,AR,923,297432,0,174,49945,0,0,2021-01-23,AR,25412,923483,1820,127438,27232,1050921
1053,2021-01-23,AR,923,297432,0,174,49945,0,0,2021-01-23,AR,13416,396581,1785,92119,15201,488700
1054,2021-01-23,AR,923,297432,0,174,49945,0,0,2021-01-23,AR,11738,99341,514,38833,12252,138174
1055,2021-01-23,AR,923,297432,0,174,49945,0,0,2021-01-23,AR,165,36902,426,4912,591,41814
1056,2021-01-23,AR,942,326524,0,213,56455,0,0,2021-01-23,AR,4980,5417413,10847,4619668,15827,10037081
1057,2021-01-23,AR,942,326524,0,213,56455,0,0,2021-01-23,AR,9979,5218123,24525,4162004,34504,9380127
1058,2021-01-23,AR,942,326524,0,213,56455,0,0,2021-01-23,AR,21987,4735868,8542,3658731,30529,8394599
1059,2021-01-23,AR,942,326524,0,213,56455,0,0,2021-01-23,AR,23325,4213686,19643,3071041,42968,7284727
1060,2021-01-23,AR,942,326524,0,213,56455,0,0,2021-01-23,AR,18367,3969748,42234,1838137,60601,5807885
1061,2021-01-23,AR,942,326524,0,213,56455,0,0,2021-01-23,AR,45393,3420480,12601,862162,57994,4282642
1062,2021-01-23,AR,942,326524,0,213,56455,0,0,2021-01-23,AR,33624,2211866,4123,557135,37747,2769001
1063,2021-01-23,AR,942,326524,0,213,56455,0,0,2021-01-23,AR,2980,1286592,3437,354446,6417,1641038
1064,2021-01-23,AR,942,326524,0,213,56455,0,0,2021-01-23,AR,25412,923483,1820,127438,27232,1050921
1065,2021-01-23,AR,942,326524,0,213,56455,0,0,2021-01-23,AR,13416,396581,1785,92119,15201,488700
1066,2021-01-23,AR,942,326524,0,213,56455,0,0,2021-01-23,AR,11738,99341,514,38833,12252,138174
1067,2021-01-23,AR,942,326524,0,213,56455,0,0,2021-01-23,AR,165,36902,426,4912,591,41814
1068,2021-01-23,AR,976,359761,0,211,63836,0,0,2021-01-23,AR,4980,5417413,10847,4619668,15827,10037081
1069,2021-01-23,AR,976,359761,0,211,63836,0,0,2021-01-23,AR,9979,5218123,24525,4162004,34504,9380127
1070,2021-01-23,AR,976,359761,0,211,63836,0,0,2021-01-23,AR,21987,4735868,8542,3658731,30529,8394599
1071,2021-01-23,AR,976,359761,0,211,63836,0,0,2021-01-23,AR,23325,4213686,19643,3071041,42968,7284727
1072,2021-01-23,AR,976,359761,0,211,63836,0,0,2021-01-23,AR,18367,3969748,42234,1838137,60601,5807885
1073,2021-01-23,AR,976,359761,0,211,63836,0,0,2021-01-23,AR,45393,3420480,12601,862162,57994,4282642
1074,2021-01-23,AR,976,359761,0,211,63836,0,0,2021-01-23,AR,33624,2211866,4123,557135,37747,2769001
1075,2021-01-23,AR,976,359761,0,211,63836,0,0,2021-01-23,AR,2980,1286592,3437,354446,6417,1641038
1076,2021-01-23,AR,976,359761,0,211,63836,0,0,2021-01-23,AR,25412,923483,1820,127438,27232,1050921
1077,2021-01-23,AR,976,359761,0,211,63836,0,0,2021-01-23,AR,13416,396581,1785,92119,15201,488700
1078,2021-01-23,AR,976,359761,0,211,63836,0,0,2021-01-23,AR,11738,99341,514,38833,12252,138174
1079,2021-01-23,AR,976,359761,0,211,63836,0,0,2021-01-23,AR,165,36902,426,4912,591,41814
1080,2021-01-23,AR,703,383348,0,137,68535,0,0,2021-01-23,AR,4980,5417413,10847,4619668,15827,10037081
1081,2021-01-23,AR,703,383348,0,137,68535,0,0,2021-01-23,AR,9979,5218123,24525,4162004,34504,9380127
1082,2021-01-23,AR,703,383348,0,137,68535,0,0,2021-01-23,AR,21987,4735868,8542,3658731,30529,8394599
1083,2021-01-23,AR,703,383348,0,137,68535,0,0,2021-01-23,AR,23325,4213686,19643,3071041,42968,7284727
1084,2021-01-23,AR,703,383348,0,137,68535,0,0,2021-01-23,AR,18367,3969748,42234,1838137,60601,5807885
1085,2021-01-23,AR,703,383348,0,137,68535,0,0,2021-01-23,AR,45393,3420480,12601,862162,57994,4282642
1086,2021-01-23,AR,703,383348,0,137,68535,0,0,2021-01-23,AR,33624,2211866,4123,557135,37747,2769001
1087,2021-01-23,AR,703,383348,0,137,68535,0,0,2021-01-23,AR,2980,1286592,3437,354446,6417,1641038
1088,2021-01-23,AR,703,383348,0,137,68535,0,0,2021-01-23,AR,25412,923483,1820,127438,27232,1050921
1089,2021-01-23,AR,703,383348,0,137,68535,0,0,2021-01-23,AR,13416,396581,1785,92119,15201,488700
1090,2021-01-23,AR,703,383348,0,137,68535,0,0,2021-01-23,AR,11738,99341,514,38833,12252,138174
1091,2021-01-23,AR,703,383348,0,137,68535,0,0,2021-01-23,AR,165,36902,426,4912,591,41814
1092,2021-01-23,AR,525,401079,0,75,71743,0,0,2021-01-23,AR,4980,5417413,10847,4619668,15827,10037081
1093,2021-01-23,AR,525,401079,0,75,71743,0,0,2021-01-23,AR,9979,5218123,24525,4162004,34504,9380127
1094,2021-01-23,AR,525,401079,0,75,71743,0,0,2021-01-23,AR,21987,4735868,8542,3658731,30529,8394599
1095,2021-01-23,AR,525,401079,0,75,71743,0,0,2021-01-23,AR,23325,4213686,19643,3071041,42968,7284727
1096,2021-01-23,AR,525,401079,0,75,71743,0,0,2021-01-23,AR,18367,3969748,42234,1838137,60601,5807885
1097,2021-01-23,AR,525,401079,0,75,71743,0,0,2021-01-23,AR,45393,3420480,12601,862162,57994,4282642
1098,2021-01-23,AR,525,401079,0,75,71743,0,0,2021-01-23,AR,33624,2211866,4123,557135,37747,2769001
1099,2021-01-23,AR,525,401079,0,75,71743,0,0,2021-01-23,AR,2980,1286592,3437,354446,6417,1641038
1100,2021-01-23,AR,525,401079,0,75,71743,0,0,2021-01-23,AR,25412,923483,1820,127438,27232,1050921
1101,2021-01-23,AR,525,401079,0,75,71743,0,0,2021-01-23,AR,13416,396581,1785,92119,15201,488700
1102,2021-01-23,AR,525,401079,0,75,71743,0,0,2021-01-23,AR,11738,99341,514,38833,12252,138174
1103,2021-01-23,AR,525,401079,0,75,71743,0,0,2021-01-23,AR,165,36902,426,4912,591,41814
1104,2021-01-23,AR,317,412972,0,40,73419,0,0,2021-01-23,AR,4980,5417413,10847,4619668,15827,10037081
1105,2021-01-23,AR,317,412972,0,40,73419,0,0,2021-01-23,AR,9979,5218123,24525,4162004,34504,9380127
1106,2021-01-23,AR,317,412972,0,40,73419,0,0,2021-01-23,AR,21987,4735868,8542,3658731,30529,8394599
1107,2021-01-23,AR,317,412972,0,40,73419,0,0,2021-01-23,AR,23325,4213686,19643,3071041,42968,7284727
1108,2021-01-23,AR,317,412972,0,40,73419,0,0,2021-01-23,AR,18367,3969748,42234,1838137,60601,5807885
1109,2021-01-23,AR,317,412972,0,40,73419,0,0,2021-01-23,AR,45393,3420480,12601,862162,57994,4282642
1110,2021-01-23,AR,317,412972,0,40,73419,0,0,2021-01-23,AR,33624,2211866,4123,557135,37747,2769001
1111,2021-01-23,AR,317,412972,0,40,73419,0,0,2021-01-23,AR,2980,1286592,3437,354446,6417,1641038
1112,2021-01-23,AR,317,412972,0,40,73419,0,0,2021-01-23,AR,25412,923483,1820,127438,27232,1050921
1113,2021-01-23,AR,317,412972,0,40,73419,0,0,2021-01-23,AR,13416,396581,1785,92119,15201,488700
1114,2021-01-23,AR,317,412972,0,40,73419,0,0,2021-01-23,AR,11738,99341,514,38833,12252,138174
1115,2021-01-23,AR,317,412972,0,40,73419,0,0,2021-01-23,AR,165,36902,426,4912,591,41814
1116,2021-01-23,AR,196,420627,0,31,74341,0,0,2021-01-23,AR,4980,5417413,10847,4619668,15827,10037081
1117,2021-01-23,AR,196,420627,0,31,74341,0,0,2021-01-23,AR,9979,5218123,24525,4162004,34504,9380127
1118,2021-01-23,AR,196,420627,0,31,74341,0,0,2021-01-23,AR,21987,4735868,8542,3658731,30529,8394599
1119,2021-01-23,AR,196,420627,0,31,74341,0,0,2021-01-23,AR,23325,4213686,19643,3071041,42968,7284727
1120,2021-01-23,AR,196,420627,0,31,74341,0,0,2021-01-23,AR,18367,3969748,42234,1838137,60601,5807885
1121,2021-01-23,AR,196,420627,0,31,74341,0,0,2021-01-23,AR,45393,3420480,12601,862162,57994,4282642
1122,2021-01-23,AR,196,420627,0,31,74341,0,0,2021-01-23,AR,33624,2211866,4123,557135,37747,2769001
1123,2021-01-23,AR,196,420627,0,31,74341,0,0,2021-01-23,AR,2980,1286592,3437,354446,6417,1641038
1124,2021-01-23,AR,196,420627,0,31,74341,0,0,2021-01-23,AR,25412,923483,1820,127438,27232,1050921
1125,2021-01-23,AR,196,420627,0,31,74341,0,0,2021-01-23,AR,13416,396581,1785,92119,15201,488700
1126,2021-01-23,AR,196,420627,0,31,74341,0,0,2021-01-23,AR,11738,99341,514,38833,12252,138174
1127,2021-01-23,AR,196,420627,0,31,74341,0,0,2021-01-23,AR,165,36902,426,4912,591,41814
1128,2021-01-23,AR,231,427733,0,44,75222,0,0,2021-01-23,AR,4980,5417413,10847,4619668,15827,10037081
1129,2021-01-23,AR,231,427733,0,44,75222,0,0,2021-01-23,AR,9979,5218123,24525,4162004,34504,9380127
1130,2021-01-23,AR,231,427733,0,44,75222,0,0,2021-01-23,AR,21987,4735868,8542,3658731,30529,8394599
1131,2021-01-23,AR,231,427733,0,44,75222,0,0,2021-01-23,AR,23325,4213686,19643,3071041,42968,7284727
1132,2021-01-23,AR,231,427733,0,44,75222,0,0,2021-01-23,AR,18367,3969748,42234,1838137,60601,5807885
1133,2021-01-23,AR,231,427733,0,44,75222,0,0,2021-01-23,AR,45393,3420480,12601,862162,57994,4282642
1134,2021-01-23,AR,231,427733,0,44,75222,0,0,2021-01-23,AR,33624,2211866,4123,557135,37747,2769001
1135,2021-01-23,AR,231,427733,0,44,75222,0,0,2021-01-23,AR,2980,1286592,3437,354446,6417,1641038
1136,2021-01-23,AR,231,427733,0,44,75222,0,0,2021-01-23,AR,25412,923483,1820,127438,27232,1050921
1137,2021-01-23,AR,231,427733,0,44,75222,0,0,2021-01-23,AR,13416,396581,1785,92119,15201,488700
1138,2021-01-23,AR,231,427733,0,44,75222,0,0,2021-01-23,AR,11738,99341,514,38833,12252,138174
1139,2021-01-23,AR,231,427733,0,44,75222,0,0,2021-01-23,AR,165,36902,426,4912,591,41814
1140,2021-01-23,AR,225,434478,0,35,76196,0,0,2021-01-23,AR,4980,5417413,10847,4619668,15827,10037081
1141,2021-01-23,AR,225,434478,0,35,76196,0,0,2021-01-23,AR,9979,5218123,24525,4162004,34504,9380127
1142,2021-01-23,AR,225,434478,0,35,76196,0,0,2021-01-23,AR,21987,4735868,8542,3658731,30529,8394599
1143,2021-01-23,AR,225,434478,0,35,76196,0,0,2021-01-23,AR,23325,4213686,19643,3071041,42968,7284727
1144,2021-01-23,AR,225,434478,0,35,76196,0,0,2021-01-23,AR,18367,3969748,42234,1838137,60601,5807885
1145,2021-01-23,AR,225,434478,0,35,76196,0,0,2021-01-23,AR,45393,3420480,12601,862162,57994,4282642
1146,2021-01-23,AR,225,434478,0,35,76196,0,0,2021-01-23,AR,33624,2211866,4123,557135,37747,2769001
1147,2021-01-23,AR,225,434478,0,35,76196,0,0,2021-01-23,AR,2980,1286592,3437,354446,6417,1641038
1148,2021-01-23,AR,225,434478,0,35,76196,0,0,2021-01-23,AR,25412,923483,1820,127438,27232,1050921
1149,2021-01-23,AR,225,434478,0,35,76196,0,0,2021-01-23,AR,13416,396581,1785,92119,15201,488700
1150,2021-01-23,AR,225,434478,0,35,76196,0,0,2021-01-23,AR,11738,99341,514,38833,12252,138174
1151,2021-01-23,AR,225,434478,0,35,76196,0,0,2021-01-23,AR,165,36902,426,4912,591,41814
1152,2021-01-09,AR,553,238578,0,97,38212,0,0,2021-01-09,AR,7628,5338147,16843,4442351,24471,9780498
1153,2021-01-09,AR,553,238578,0,97,38212,0,0,2021-01-09,AR,22220,5112083,17395,3893704,39615,9005787
1154,2021-01-09,AR,553,238578,0,97,38212,0,0,2021-01-09,AR,1709,4328930,13523,3450529,15232,7779459
1155,2021-01-09,AR,553,238578,0,97,38212,0,0,2021-01-09,AR,6940,4120079,49165,2620891,56105,6740970
1156,2021-01-09,AR,553,238578,0,97,38212,0,0,2021-01-09,AR,15820,3809174,41222,1316351,57042,5125525
1157,2021-01-09,AR,553,238578,0,97,38212,0,0,2021-01-09,AR,34814,2837374,14074,728467,48888,3565841
1158,2021-01-09,AR,553,238578,0,97,38212,0,0,2021-01-09,AR,48426,1798744,3049,461751,51475,2260495
1159,2021-01-09,AR,553,238578,0,97,38212,0,0,2021-01-09,AR,2243,1139729,413,207206,2656,1346935
1160,2021-01-09,AR,553,238578,0,97,38212,0,0,2021-01-09,AR,31954,691682,1840,105478,33794,797160
1161,2021-01-09,AR,553,238578,0,97,38212,0,0,2021-01-09,AR,16246,228082,304,51064,16550,279146
1162,2021-01-09,AR,553,238578,0,97,38212,0,0,2021-01-09,AR,2022,50304,805,29887,2827,80191
1163,2021-01-09,AR,553,238578,0,97,38212,0,0,2021-01-09,AR,1420,18628,0,5,1420,18633
1164,2021-01-09,AR,517,255048,0,74,41466,0,0,2021-01-09,AR,7628,5338147,16843,4442351,24471,9780498
1165,2021-01-09,AR,517,255048,0,74,41466,0,0,2021-01-09,AR,22220,5112083,17395,3893704,39615,9005787
1166,2021-01-09,AR,517,255048,0,74,41466,0,0,2021-01-09,AR,1709,4328930,13523,3450529,15232,7779459
1167,2021-01-09,AR,517,255048,0,74,41466,0,0,2021-01-09,AR,6940,4120079,49165,2620891,56105,6740970
1168,2021-01-09,AR,517,255048,0,74,41466,0,0,2021-01-09,AR,15820,3809174,41222,1316351,57042,5125525
1169,2021-01-09,AR,517,255048,0,74,41466,0,0,2021-01-09,AR,34814,2837374,14074,728467,48888,3565841
1170,2021-01-09,AR,517,255048,0,74,41466,0,0,2021-01-09,AR,48426,1798744,3049,461751,51475,2260495
1171,2021-01-09,AR,517,255048,0,74,41466,0,0,2021-01-09,AR,2243,1139729,413,207206,2656,1346935
1172,2021-01-09,AR,517,255048,0,74,41466,0,0,2021-01-09,AR,31954,691682,1840,105478,33794,797160
1173,2021-01-09,AR,517,255048,0,74,41466,0,0,2021-01-09,AR,16246,228082,304,51064,16550,279146
1174,2021-01-09,AR,517,255048,0,74,41466,0,0,2021-01-09,AR,2022,50304,805,29887,2827,80191
1175,2021-01-09,AR,517,255048,0,74,41466,0,0,2021-01-09,AR,1420,18628,0,5,1420,18633
1176,2021-01-09,AR,459,267295,0,93,43799,0,0,2021-01-09,AR,7628,5338147,16843,4442351,24471,9780498
1177,2021-01-09,AR,459,267295,0,93,43799,0,0,2021-01-09,AR,22220,5112083,17395,3893704,39615,9005787
1178,2021-01-09,AR,459,267295,0,93,43799,0,0,2021-01-09,AR,1709,4328930,13523,3450529,15232,7779459
1179,2021-01-09,AR,459,267295,0,93,43799,0,0,2021-01-09,AR,6940,4120079,49165,2620891,56105,6740970
1180,2021-01-09,AR,459,267295,0,93,43799,0,0,2021-01-09,AR,15820,3809174,41222,1316351,57042,5125525
1181,2021-01-09,AR,459,267295,0,93,43799,0,0,2021-01-09,AR,34814,2837374,14074,728467,48888,3565841
1182,2021-01-09,AR,459,267295,0,93,43799,0,0,2021-01-09,AR,48426,1798744,3049,461751,51475,2260495
1183,2021-01-09,AR,459,267295,0,93,43799,0,0,2021-01-09,AR,2243,1139729,413,207206,2656,1346935
1184,2021-01-09,AR,459,267295,0,93,43799,0,0,2021-01-09,AR,31954,691682,1840,105478,33794,797160
1185,2021-01-09,AR,459,267295,0,93,43799,0,0,2021-01-09,AR,16246,228082,304,51064,16550,279146
1186,2021-01-09,AR,459,267295,0,93,43799,0,0,2021-01-09,AR,2022,50304,805,29887,2827,80191
1187,2021-01-09,AR,459,267295,0,93,43799,0,0,2021-01-09,AR,1420,18628,0,5,1420,18633
1188,2021-01-09,AR,771,284596,0,140,47317,0,0,2021-01-09,AR,7628,5338147,16843,4442351,24471,9780498
1189,2021-01-09,AR,771,284596,0,140,47317,0,0,2021-01-09,AR,22220,5112083,17395,3893704,39615,9005787
1190,2021-01-09,AR,771,284596,0,140,47317,0,0,2021-01-09,AR,1709,4328930,13523,3450529,15232,7779459
1191,2021-01-09,AR,771,284596,0,140,47317,0,0,2021-01-09,AR,6940,4120079,49165,2620891,56105,6740970
1192,2021-01-09,AR,771,284596,0,140,47317,0,0,2021-01-09,AR,15820,3809174,41222,1316351,57042,5125525
1193,2021-01-09,AR,771,284596,0,140,47317,0,0,2021-01-09,AR,34814,2837374,14074,728467,48888,3565841
1194,2021-01-09,AR,771,284596,0,140,47317,0,0,2021-01-09,AR,48426,1798744,3049,461751,51475,2260495
1195,2021-01-09,AR,771,284596,0,140,47317,0,0,2021-01-09,AR,2243,1139729,413,207206,2656,1346935
1196,2021-01-09,AR,771,284596,0,140,47317,0,0,2021-01-09,AR,31954,691682,1840,105478,33794,797160
1197,2021-01-09,AR,771,284596,0,140,47317,0,0,2021-01-09,AR,16246,228082,304,51064,16550,279146
1198,2021-01-09,AR,771,284596,0,140,47317,0,0,2021-01-09,AR,2022,50304,805,29887,2827,80191
1199,2021-01-09,AR,771,284596,0,140,47317,0,0,2021-01-09,AR,1420,18628,0,5,1420,18633
1200,2021-01-09,AR,773,311613,0,166,53150,0,0,2021-01-09,AR,7628,5338147,16843,4442351,24471,9780498
1201,2021-01-09,AR,773,311613,0,166,53150,0,0,2021-01-09,AR,22220,5112083,17395,3893704,39615,9005787
1202,2021-01-09,AR,773,311613,0,166,53150,0,0,2021-01-09,AR,1709,4328930,13523,3450529,15232,7779459
1203,2021-01-09,AR,773,311613,0,166,53150,0,0,2021-01-09,AR,6940,4120079,49165,2620891,56105,6740970
1204,2021-01-09,AR,773,311613,0,166,53150,0,0,2021-01-09,AR,15820,3809174,41222,1316351,57042,5125525
1205,2021-01-09,AR,773,311613,0,166,53150,0,0,2021-01-09,AR,34814,2837374,14074,728467,48888,3565841
1206,2021-01-09,AR,773,311613,0,166,53150,0,0,2021-01-09,AR,48426,1798744,3049,461751,51475,2260495
1207,2021-01-09,AR,773,311613,0,166,53150,0,0,2021-01-09,AR,2243,1139729,413,207206,2656,1346935
1208,2021-01-09,AR,773,311613,0,166,53150,0,0,2021-01-09,AR,31954,691682,1840,105478,33794,797160
1209,2021-01-09,AR,773,311613,0,166,53150,0,0,2021-01-09,AR,16246,228082,304,51064,16550,279146
1210,2021-01-09,AR,773,311613,0,166,53150,0,0,2021-01-09,AR,2022,50304,805,29887,2827,80191
1211,2021-01-09,AR,773,311613,0,166,53150,0,0,2021-01-09,AR,1420,18628,0,5,1420,18633
1212,2021-01-09,AR,1163,346639,0,265,60902,0,0,2021-01-09,AR,7628,5338147,16843,4442351,24471,9780498
1213,2021-01-09,AR,1163,346639,0,265,60902,0,0,2021-01-09,AR,22220,5112083,17395,3893704,39615,9005787
1214,2021-01-09,AR,1163,346639,0,265,60902,0,0,2021-01-09,AR,1709,4328930,13523,3450529,15232,7779459
1215,2021-01-09,AR,1163,346639,0,265,60902,0,0,2021-01-09,AR,6940,4120079,49165,2620891,56105,6740970
1216,2021-01-09,AR,1163,346639,0,265,60902,0,0,2021-01-09,AR,15820,3809174,41222,1316351,57042,5125525
1217,2021-01-09,AR,1163,346639,0,265,60902,0,0,2021-01-09,AR,34814,2837374,14074,728467,48888,3565841
1218,2021-01-09,AR,1163,346639,0,265,60902,0,0,2021-01-09,AR,48426,1798744,3049,461751,51475,2260495
1219,2021-01-09,AR,1163,346639,0,265,60902,0,0,2021-01-09,AR,2243,1139729,413,207206,2656,1346935
1220,2021-01-09,AR,1163,346639,0,265,60902,0,0,2021-01-09,AR,31954,691682,1840,105478,33794,797160
1221,2021-01-09,AR,1163,346639,0,265,60902,0,0,2021-01-09,AR,16246,228082,304,51064,16550,279146
1222,2021-01-09,AR,1163,346639,0,265,60902,0,0,2021-01-09,AR,2022,50304,805,29887,2827,80191
1223,2021-01-09,AR,1163,346639,0,265,60902,0,0,2021-01-09,AR,1420,18628,0,5,1420,18633
1224,2021-01-09,AR,732,372975,0,143,66519,0,0,2021-01-09,AR,7628,5338147,16843,4442351,24471,9780498
1225,2021-01-09,AR,732,372975,0,143,66519,0,0,2021-01-09,AR,22220,5112083,17395,3893704,39615,9005787
1226,2021-01-09,AR,732,372975,0,143,66519,0,0,2021-01-09,AR,1709,4328930,13523,3450529,15232,7779459
1227,2021-01-09,AR,732,372975,0,143,66519,0,0,2021-01-09,AR,6940,4120079,49165,2620891,56105,6740970
1228,2021-01-09,AR,732,372975,0,143,66519,0,0,2021-01-09,AR,15820,3809174,41222,1316351,57042,5125525
1229,2021-01-09,AR,732,372975,0,143,66519,0,0,2021-01-09,AR,34814,2837374,14074,728467,48888,3565841
1230,2021-01-09,AR,732,372975,0,143,66519,0,0,2021-01-09,AR,48426,1798744,3049,461751,51475,2260495
1231,2021-01-09,AR,732,372975,0,143,66519,0,0,2021-01-09,AR,2243,1139729,413,207206,2656,1346935
1232,2021-01-09,AR,732,372975,0,143,66519,0,0,2021-01-09,AR,31954,691682,1840,105478,33794,797160
1233,2021-01-09,AR,732,372975,0,143,66519,0,0,2021-01-09,AR,16246,228082,304,51064,16550,279146
1234,2021-01-09,AR,732,372975,0,143,66519,0,0,2021-01-09,AR,2022,50304,805,29887,2827,80191
1235,2021-01-09,AR,732,372975,0,143,66519,0,0,2021-01-09,AR,1420,18628,0,5,1420,18633
1236,2021-01-09,AR,617,393795,0,107,70491,0,0,2021-01-09,AR,7628,5338147,16843,4442351,24471,9780498
1237,2021-01-09,AR,617,393795,0,107,70491,0,0,2021-01-09,AR,22220,5112083,17395,3893704,39615,9005787
1238,2021-01-09,AR,617,393795,0,107,70491,0,0,2021-01-09,AR,1709,4328930,13523,3450529,15232,7779459
1239,2021-01-09,AR,617,393795,0,107,70491,0,0,2021-01-09,AR,6940,4120079,49165,2620891,56105,6740970
1240,2021-01-09,AR,617,393795,0,107,70491,0,0,2021-01-09,AR,15820,3809174,41222,1316351,57042,5125525
1241,2021-01-09,AR,617,393795,0,107,70491,0,0,2021-01-09,AR,34814,2837374,14074,728467,48888,3565841
1242,2021-01-09,AR,617,393795,0,107,70491,0,0,2021-01-09,AR,48426,1798744,3049,461751,51475,2260495
1243,2021-01-09,AR,617,393795,0,107,70491,0,0,2021-01-09,AR,2243,1139729,413,207206,2656,1346935
1244,2021-01-09,AR,617,393795,0,107,70491,0,0,2021-01-09,AR,31954,691682,1840,105478,33794,797160
1245,2021-01-09,AR,617,393795,0,107,70491,0,0,2021-01-09,AR,16246,228082,304,51064,16550,279146
1246,2021-01-09,AR,617,393795,0,107,70491,0,0,2021-01-09,AR,2022,50304,805,29887,2827,80191
1247,2021-01-09,AR,617,393795,0,107,70491,0,0,2021-01-09,AR,1420,18628,0,5,1420,18633
1248,2021-01-09,AR,374,408329,0,54,72842,0,0,2021-01-09,AR,7628,5338147,16843,4442351,24471,9780498
1249,2021-01-09,AR,374,408329,0,54,72842,0,0,2021-01-09,AR,22220,5112083,17395,3893704,39615,9005787
1250,2021-01-09,AR,374,408329,0,54,72842,0,0,2021-01-09,AR,1709,4328930,13523,3450529,15232,7779459
1251,2021-01-09,AR,374,408329,0,54,72842,0,0,2021-01-09,AR,6940,4120079,49165,2620891,56105,6740970
1252,2021-01-09,AR,374,408329,0,54,72842,0,0,2021-01-09,AR,15820,3809174,41222,1316351,57042,5125525
1253,2021-01-09,AR,374,408329,0,54,72842,0,0,2021-01-09,AR,34814,2837374,14074,728467,48888,3565841
1254,2021-01-09,AR,374,408329,0,54,72842,0,0,2021-01-09,AR,48426,1798744,3049,461751,51475,2260495
1255,2021-01-09,AR,374,408329,0,54,72842,0,0,2021-01-09,AR,2243,1139729,413,207206,2656,1346935
1256,2021-01-09,AR,374,408329,0,54,72842,0,0,2021-01-09,AR,31954,691682,1840,105478,33794,797160
1257,2021-01-09,AR,374,408329,0,54,72842,0,0,2021-01-09,AR,16246,228082,304,51064,16550,279146
1258,2021-01-09,AR,374,408329,0,54,72842,0,0,2021-01-09,AR,2022,50304,805,29887,2827,80191
1259,2021-01-09,AR,374,408329,0,54,72842,0,0,2021-01-09,AR,1420,18628,0,5,1420,18633
1260,2021-01-09,AR,199,417051,0,24,73913,0,0,2021-01-09,AR,7628,5338147,16843,4442351,24471,9780498
1261,2021-01-09,AR,199,417051,0,24,73913,0,0,2021-01-09,AR,22220,5112083,17395,3893704,39615,9005787
1262,2021-01-09,AR,199,417051,0,24,73913,0,0,2021-01-09,AR,1709,4328930,13523,3450529,15232,7779459
1263,2021-01-09,AR,199,417051,0,24,73913,0,0,2021-01-09,AR,6940,4120079,49165,2620891,56105,6740970
1264,2021-01-09,AR,199,417051,0,24,73913,0,0,2021-01-09,AR,15820,3809174,41222,1316351,57042,5125525
1265,2021-01-09,AR,199,417051,0,24,73913,0,0,2021-01-09,AR,34814,2837374,14074,728467,48888,3565841
1266,2021-01-09,AR,199,417051,0,24,73913,0,0,2021-01-09,AR,48426,1798744,3049,461751,51475,2260495
1267,2021-01-09,AR,199,417051,0,24,73913,0,0,2021-01-09,AR,2243,1139729,413,207206,2656,1346935
1268,2021-01-09,AR,199,417051,0,24,73913,0,0,2021-01-09,AR,31954,691682,1840,105478,33794,797160
1269,2021-01-09,AR,199,417051,0,24,73913,0,0,2021-01-09,AR,16246,228082,304,51064,16550,279146
1270,2021-01-09,AR,199,417051,0,24,73913,0,0,2021-01-09,AR,2022,50304,805,29887,2827,80191
1271,2021-01-09,AR,199,417051,0,24,73913,0,0,2021-01-09,AR,1420,18628,0,5,1420,18633
1272,2021-01-09,AR,282,424746,0,36,74825,0,0,2021-01-09,AR,7628,5338147,16843,4442351,24471,9780498
1273,2021-01-09,AR,282,424746,0,36,74825,0,0,2021-01-09,AR,22220,5112083,17395,3893704,39615,9005787
1274,2021-01-09,AR,282,424746,0,36,74825,0,0,2021-01-09,AR,1709,4328930,13523,3450529,15232,7779459
1275,2021-01-09,AR,282,424746,0,36,74825,0,0,2021-01-09,AR,6940,4120079,49165,2620891,56105,6740970
1276,2021-01-09,AR,282,424746,0,36,74825,0,0,2021-01-09,AR,15820,3809174,41222,1316351,57042,5125525
1277,2021-01-09,AR,282,424746,0,36,74825,0,0,2021-01-09,AR,34814,2837374,14074,728467,48888,3565841
1278,2021-01-09,AR,282,424746,0,36,74825,0,0,2021-01-09,AR,48426,1798744,3049,461751,51475,2260495
1279,2021-01-09,AR,282,424746,0,36,74825,0,0,2021-01-09,AR,2243,1139729,413,207206,2656,1346935
1280,2021-01-09,AR,282,424746,0,36,74825,0,0,2021-01-09,AR,31954,691682,1840,105478,33794,797160
1281,2021-01-09,AR,282,424746,0,36,74825,0,0,2021-01-09,AR,16246,228082,304,51064,16550,279146
1282,2021-01-09,AR,282,424746,0,36,74825,0,0,2021-01-09,AR,2022,50304,805,29887,2827,80191
1283,2021-01-09,AR,282,424746,0,36,74825,0,0,2021-01-09,AR,1420,18628,0,5,1420,18633
1284,2021-01-09,AR,241,431367,0,22,75700,0,0,2021-01-09,AR,7628,5338147,16843,4442351,24471,9780498
1285,2021-01-09,AR,241,431367,0,22,75700,0,0,2021-01-09,AR,22220,5112083,17395,3893704,39615,9005787
1286,2021-01-09,AR,241,431367,0,22,75700,0,0,2021-01-09,AR,1709,4328930,13523,3450529,15232,7779459
1287,2021-01-09,AR,241,431367,0,22,75700,0,0,2021-01-09,AR,6940,4120079,49165,2620891,56105,6740970
1288,2021-01-09,AR,241,431367,0,22,75700,0,0,2021-01-09,AR,15820,3809174,41222,1316351,57042,5125525
1289,2021-01-09,AR,241,431367,0,22,75700,0,0,2021-01-09,AR,34814,2837374,14074,728467,48888,3565841
1290,2021-01-09,AR,241,431367,0,22,75700,0,0,2021-01-09,AR,48426,1798744,3049,461751,51475,2260495
1291,2021-01-09,AR,241,431367,0,22,75700,0,0,2021-01-09,AR,2243,1139729,413,207206,2656,1346935
1292,2021-01-09,AR,241,431367,0,22,75700,0,0,2021-01-09,AR,31954,691682,1840,105478,33794,797160
1293,2021-01-09,AR,241,431367,0,22,75700,0,0,2021-01-09,AR,16246,228082,304,51064,16550,279146
1294,2021-01-09,AR,241,431367,0,22,75700,0,0,2021-01-09,AR,2022,50304,805,29887,2827,80191
1295,2021-01-09,AR,241,431367,0,22,75700,0,0,2021-01-09,AR,1420,18628,0,5,1420,18633
1296,2021-01-01,AR,450,233586,0,87,37363,0,0,2021-01-01,AR,11303,5281234,17926,4317589,29229,9598823
1297,2021-01-01,AR,450,233586,0,87,37363,0,0,2021-01-01,AR,26586,4972904,11955,3764676,38541,8737580
1298,2021-01-01,AR,450,233586,0,87,37363,0,0,2021-01-01,AR,8797,4271166,36352,3291700,45149,7562866
1299,2021-01-01,AR,450,233586,0,87,37363,0,0,2021-01-01,AR,11272,4061715,52508,2244232,63780,6305947
1300,2021-01-01,AR,450,233586,0,87,37363,0,0,2021-01-01,AR,11204,3656428,13363,1048920,24567,4705348
1301,2021-01-01,AR,450,233586,0,87,37363,0,0,2021-01-01,AR,45565,2532689,17733,622481,63298,3155170
1302,2021-01-01,AR,450,233586,0,87,37363,0,0,2021-01-01,AR,36919,1453774,7238,424463,44157,1878237
1303,2021-01-01,AR,450,233586,0,87,37363,0,0,2021-01-01,AR,2374,1039694,476,141522,2850,1181216
1304,2021-01-01,AR,450,233586,0,87,37363,0,0,2021-01-01,AR,15805,518631,285,98925,16090,617556
1305,2021-01-01,AR,450,233586,0,87,37363,0,0,2021-01-01,AR,9493,143037,1080,44041,10573,187078
1306,2021-01-01,AR,450,233586,0,87,37363,0,0,2021-01-01,AR,279,39973,2317,16607,2596,56580
1307,2021-01-01,AR,450,233586,0,87,37363,0,0,2021-01-01,AR,15,6015,0,0,15,6015
1308,2021-01-01,AR,526,251145,0,104,40693,0,0,2021-01-01,AR,11303,5281234,17926,4317589,29229,9598823
1309,2021-01-01,AR,526,251145,0,104,40693,0,0,2021-01-01,AR,26586,4972904,11955,3764676,38541,8737580
1310,2021-01-01,AR,526,251145,0,104,40693,0,0,2021-01-01,AR,8797,4271166,36352,3291700,45149,7562866
1311,2021-01-01,AR,526,251145,0,104,40693,0,0,2021-01-01,AR,11272,4061715,52508,2244232,63780,6305947
1312,2021-01-01,AR,526,251145,0,104,40693,0,0,2021-01-01,AR,11204,3656428,13363,1048920,24567,4705348
1313,2021-01-01,AR,526,251145,0,104,40693,0,0,2021-01-01,AR,45565,2532689,17733,622481,63298,3155170
1314,2021-01-01,AR,526,251145,0,104,40693,0,0,2021-01-01,AR,36919,1453774,7238,424463,44157,1878237
1315,2021-01-01,AR,526,251145,0,104,40693,0,0,2021-01-01,AR,2374,1039694,476,141522,2850,1181216
1316,2021-01-01,AR,526,251145,0,104,40693,0,0,2021-01-01,AR,15805,518631,285,98925,16090,617556
1317,2021-01-01,AR,526,251145,0,104,40693,0,0,2021-01-01,AR,9493,143037,1080,44041,10573,187078
1318,2021-01-01,AR,526,251145,0,104,40693,0,0,2021-01-01,AR,279,39973,2317,16607,2596,56580
1319,2021-01-01,AR,526,251145,0,104,40693,0,0,2021-01-01,AR,15,6015,0,0,15,6015
1320,2021-01-01,AR,573,263743,0,97,43138,0,0,2021-01-01,AR,11303,5281234,17926,4317589,29229,9598823
1321,2021-01-01,AR,573,263743,0,97,43138,0,0,2021-01-01,AR,26586,4972904,11955,3764676,38541,8737580
1322,2021-01-01,AR,573,263743,0,97,43138,0,0,2021-01-01,AR,8797,4271166,36352,3291700,45149,7562866
1323,2021-01-01,AR,573,263743,0,97,43138,0,0,2021-01-01,AR,11272,4061715,52508,2244232,63780,6305947
1324,2021-01-01,AR,573,263743,0,97,43138,0,0,2021-01-01,AR,11204,3656428,13363,1048920,24567,4705348
1325,2021-01-01,AR,573,263743,0,97,43138,0,0,2021-01-01,AR,45565,2532689,17733,622481,63298,3155170
1326,2021-01-01,AR,573,263743,0,97,43138,0,0,2021-01-01,AR,36919,1453774,7238,424463,44157,1878237
1327,2021-01-01,AR,573,263743,0,97,43138,0,0,2021-01-01,AR,2374,1039694,476,141522,2850,1181216
1328,2021-01-01,AR,573,263743,0,97,43138,0,0,2021-01-01,AR,15805,518631,285,98925,16090,617556
1329,2021-01-01,AR,573,263743,0,97,43138,0,0,2021-01-01,AR,9493,143037,1080,44041,10573,187078
1330,2021-01-01,AR,573,263743,0,97,43138,0,0,2021-01-01,AR,279,39973,2317,16607,2596,56580
1331,2021-01-01,AR,573,263743,0,97,43138,0,0,2021-01-01,AR,15,6015,0,0,15,6015
1332,2021-01-01,AR,584,278998,0,146,46165,0,0,2021-01-01,AR,11303,5281234,17926,4317589,29229,9598823
1333,2021-01-01,AR,584,278998,0,146,46165,0,0,2021-01-01,AR,26586,4972904,11955,3764676,38541,8737580
1334,2021-01-01,AR,584,278998,0,146,46165,0,0,2021-01-01,AR,8797,4271166,36352,3291700,45149,7562866
1335,2021-01-01,AR,584,278998,0,146,46165,0,0,2021-01-01,AR,11272,4061715,52508,2244232,63780,6305947
1336,2021-01-01,AR,584,278998,0,146,46165,0,0,2021-01-01,AR,11204,3656428,13363,1048920,24567,4705348
1337,2021-01-01,AR,584,278998,0,146,46165,0,0,2021-01-01,AR,45565,2532689,17733,622481,63298,3155170
1338,2021-01-01,AR,584,278998,0,146,46165,0,0,2021-01-01,AR,36919,1453774,7238,424463,44157,1878237
1339,2021-01-01,AR,584,278998,0,146,46165,0,0,2021-01-01,AR,2374,1039694,476,141522,2850,1181216
1340,2021-01-01,AR,584,278998,0,146,46165,0,0,2021-01-01,AR,15805,518631,285,98925,16090,617556
1341,2021-01-01,AR,584,278998,0,146,46165,0,0,2021-01-01,AR,9493,143037,1080,44041,10573,187078
1342,2021-01-01,AR,584,278998,0,146,46165,0,0,2021-01-01,AR,279,39973,2317,16607,2596,56580
1343,2021-01-01,AR,584,278998,0,146,46165,0,0,2021-01-01,AR,15,6015,0,0,15,6015
1344,2021-01-01,AR,763,304525,0,174,51544,0,0,2021-01-01,AR,11303,5281234,17926,4317589,29229,9598823
1345,2021-01-01,AR,763,304525,0,174,51544,0,0,2021-01-01,AR,26586,4972904,11955,3764676,38541,8737580
1346,2021-01-01,AR,763,304525,0,174,51544,0,0,2021-01-01,AR,8797,4271166,36352,3291700,45149,7562866
1347,2021-01-01,AR,763,304525,0,174,51544,0,0,2021-01-01,AR,11272,4061715,52508,2244232,63780,6305947
1348,2021-01-01,AR,763,304525,0,174,51544,0,0,2021-01-01,AR,11204,3656428,13363,1048920,24567,4705348
1349,2021-01-01,AR,763,304525,0,174,51544,0,0,2021-01-01,AR,45565,2532689,17733,622481,63298,3155170
1350,2021-01-01,AR,763,304525,0,174,51544,0,0,2021-01-01,AR,36919,1453774,7238,424463,44157,1878237
1351,2021-01-01,AR,763,304525,0,174,51544,0,0,2021-01-01,AR,2374,1039694,476,141522,2850,1181216
1352,2021-01-01,AR,763,304525,0,174,51544,0,0,2021-01-01,AR,15805,518631,285,98925,16090,617556
1353,2021-01-01,AR,763,304525,0,174,51544,0,0,2021-01-01,AR,9493,143037,1080,44041,10573,187078
1354,2021-01-01,AR,763,304525,0,174,51544,0,0,2021-01-01,AR,279,39973,2317,16607,2596,56580
1355,2021-01-01,AR,763,304525,0,174,51544,0,0,2021-01-01,AR,15,6015,0,0,15,6015
1356,2021-01-01,AR,1292,337435,0,277,58857,0,0,2021-01-01,AR,11303,5281234,17926,4317589,29229,9598823
1357,2021-01-01,AR,1292,337435,0,277,58857,0,0,2021-01-01,AR,26586,4972904,11955,3764676,38541,8737580
1358,2021-01-01,AR,1292,337435,0,277,58857,0,0,2021-01-01,AR,8797,4271166,36352,3291700,45149,7562866
1359,2021-01-01,AR,1292,337435,0,277,58857,0,0,2021-01-01,AR,11272,4061715,52508,2244232,63780,6305947
1360,2021-01-01,AR,1292,337435,0,277,58857,0,0,2021-01-01,AR,11204,3656428,13363,1048920,24567,4705348
1361,2021-01-01,AR,1292,337435,0,277,58857,0,0,2021-01-01,AR,45565,2532689,17733,622481,63298,3155170
1362,2021-01-01,AR,1292,337435,0,277,58857,0,0,2021-01-01,AR,36919,1453774,7238,424463,44157,1878237
1363,2021-01-01,AR,1292,337435,0,277,58857,0,0,2021-01-01,AR,2374,1039694,476,141522,2850,1181216
1364,2021-01-01,AR,1292,337435,0,277,58857,0,0,2021-01-01,AR,15805,518631,285,98925,16090,617556
1365,2021-01-01,AR,1292,337435,0,277,58857,0,0,2021-01-01,AR,9493,143037,1080,44041,10573,187078
1366,2021-01-01,AR,1292,337435,0,277,58857,0,0,2021-01-01,AR,279,39973,2317,16607,2596,56580
1367,2021-01-01,AR,1292,337435,0,277,58857,0,0,2021-01-01,AR,15,6015,0,0,15,6015
1368,2021-01-01,AR,846,366471,0,160,65221,0,0,2021-01-01,AR,11303,5281234,17926,4317589,29229,9598823
1369,2021-01-01,AR,846,366471,0,160,65221,0,0,2021-01-01,AR,26586,4972904,11955,3764676,38541,8737580
1370,2021-01-01,AR,846,366471,0,160,65221,0,0,2021-01-01,AR,8797,4271166,36352,3291700,45149,7562866
1371,2021-01-01,AR,846,366471,0,160,65221,0,0,2021-01-01,AR,11272,4061715,52508,2244232,63780,6305947
1372,2021-01-01,AR,846,366471,0,160,65221,0,0,2021-01-01,AR,11204,3656428,13363,1048920,24567,4705348
1373,2021-01-01,AR,846,366471,0,160,65221,0,0,2021-01-01,AR,45565,2532689,17733,622481,63298,3155170
1374,2021-01-01,AR,846,366471,0,160,65221,0,0,2021-01-01,AR,36919,1453774,7238,424463,44157,1878237
1375,2021-01-01,AR,846,366471,0,160,65221,0,0,2021-01-01,AR,2374,1039694,476,141522,2850,1181216
1376,2021-01-01,AR,846,366471,0,160,65221,0,0,2021-01-01,AR,15805,518631,285,98925,16090,617556
1377,2021-01-01,AR,846,366471,0,160,65221,0,0,2021-01-01,AR,9493,143037,1080,44041,10573,187078
1378,2021-01-01,AR,846,366471,0,160,65221,0,0,2021-01-01,AR,279,39973,2317,16607,2596,56580
1379,2021-01-01,AR,846,366471,0,160,65221,0,0,2021-01-01,AR,15,6015,0,0,15,6015
1380,2021-01-01,AR,454,388786,0,96,69565,0,0,2021-01-01,AR,11303,5281234,17926,4317589,29229,9598823
1381,2021-01-01,AR,454,388786,0,96,69565,0,0,2021-01-01,AR,26586,4972904,11955,3764676,38541,8737580
1382,2021-01-01,AR,454,388786,0,96,69565,0,0,2021-01-01,AR,8797,4271166,36352,3291700,45149,7562866
1383,2021-01-01,AR,454,388786,0,96,69565,0,0,2021-01-01,AR,11272,4061715,52508,2244232,63780,6305947
1384,2021-01-01,AR,454,388786,0,96,69565,0,0,2021-01-01,AR,11204,3656428,13363,1048920,24567,4705348
1385,2021-01-01,AR,454,388786,0,96,69565,0,0,2021-01-01,AR,45565,2532689,17733,622481,63298,3155170
1386,2021-01-01,AR,454,388786,0,96,69565,0,0,2021-01-01,AR,36919,1453774,7238,424463,44157,1878237
1387,2021-01-01,AR,454,388786,0,96,69565,0,0,2021-01-01,AR,2374,1039694,476,141522,2850,1181216
1388,2021-01-01,AR,454,388786,0,96,69565,0,0,2021-01-01,AR,15805,518631,285,98925,16090,617556
1389,2021-01-01,AR,454,388786,0,96,69565,0,0,2021-01-01,AR,9493,143037,1080,44041,10573,187078
1390,2021-01-01,AR,454,388786,0,96,69565,0,0,2021-01-01,AR,279,39973,2317,16607,2596,56580
1391,2021-01-01,AR,454,388786,0,96,69565,0,0,2021-01-01,AR,15,6015,0,0,15,6015
1392,2021-01-01,AR,457,405313,0,66,72384,0,0,2021-01-01,AR,11303,5281234,17926,4317589,29229,9598823
1393,2021-01-01,AR,457,405313,0,66,72384,0,0,2021-01-01,AR,26586,4972904,11955,3764676,38541,8737580
1394,2021-01-01,AR,457,405313,0,66,72384,0,0,2021-01-01,AR,8797,4271166,36352,3291700,45149,7562866
1395,2021-01-01,AR,457,405313,0,66,72384,0,0,2021-01-01,AR,11272,4061715,52508,2244232,63780,6305947
1396,2021-01-01,AR,457,405313,0,66,72384,0,0,2021-01-01,AR,11204,3656428,13363,1048920,24567,4705348
1397,2021-01-01,AR,457,405313,0,66,72384,0,0,2021-01-01,AR,45565,2532689,17733,622481,63298,3155170
1398,2021-01-01,AR,457,405313,0,66,72384,0,0,2021-01-01,AR,36919,1453774,7238,424463,44157,1878237
1399,2021-01-01,AR,457,405313,0,66,72384,0,0,2021-01-01,AR,2374,1039694,476,141522,2850,1181216
1400,2021-01-01,AR,457,405313,0,66,72384,0,0,2021-01-01,AR,15805,518631,285,98925,16090,617556
1401,2021-01-01,AR,457,405313,0,66,72384,0,0,2021-01-01,AR,9493,143037,1080,44041,10573,187078
1402,2021-01-01,AR,457,405313,0,66,72384,0,0,2021-01-01,AR,279,39973,2317,16607,2596,56580
1403,2021-01-01,AR,457,405313,0,66,72384,0,0,2021-01-01,AR,15,6015,0,0,15,6015
1404,2021-01-01,AR,259,415056,0,36,73679,0,0,2021-01-01,AR,11303,5281234,17926,4317589,29229,9598823
1405,2021-01-01,AR,259,415056,0,36,73679,0,0,2021-01-01,AR,26586,4972904,11955,3764676,38541,8737580
1406,2021-01-01,AR,259,415056,0,36,73679,0,0,2021-01-01,AR,8797,4271166,36352,3291700,45149,7562866
1407,2021-01-01,AR,259,415056,0,36,73679,0,0,2021-01-01,AR,11272,4061715,52508,2244232,63780,6305947
1408,2021-01-01,AR,259,415056,0,36,73679,0,0,2021-01-01,AR,11204,3656428,13363,1048920,24567,4705348
1409,2021-01-01,AR,259,415056,0,36,73679,0,0,2021-01-01,AR,45565,2532689,17733,622481,63298,3155170
1410,2021-01-01,AR,259,415056,0,36,73679,0,0,2021-01-01,AR,36919,1453774,7238,424463,44157,1878237
1411,2021-01-01,AR,259,415056,0,36,73679,0,0,2021-01-01,AR,2374,1039694,476,141522,2850,1181216
1412,2021-01-01,AR,259,415056,0,36,73679,0,0,2021-01-01,AR,15805,518631,285,98925,16090,617556
1413,2021-01-01,AR,259,415056,0,36,73679,0,0,2021-01-01,AR,9493,143037,1080,44041,10573,187078
1414,2021-01-01,AR,259,415056,0,36,73679,0,0,2021-01-01,AR,279,39973,2317,16607,2596,56580
1415,2021-01-01,AR,259,415056,0,36,73679,0,0,2021-01-01,AR,15,6015,0,0,15,6015
1416,2021-01-01,AR,274,422883,0,31,74591,0,0,2021-01-01,AR,11303,5281234,17926,4317589,29229,9598823
1417,2021-01-01,AR,274,422883,0,31,74591,0,0,2021-01-01,AR,26586,4972904,11955,3764676,38541,8737580
1418,2021-01-01,AR,274,422883,0,31,74591,0,0,2021-01-01,AR,8797,4271166,36352,3291700,45149,7562866
1419,2021-01-01,AR,274,422883,0,31,74591,0,0,2021-01-01,AR,11272,4061715,52508,2244232,63780,6305947
1420,2021-01-01,AR,274,422883,0,31,74591,0,0,2021-01-01,AR,11204,3656428,13363,1048920,24567,4705348
1421,2021-01-01,AR,274,422883,0,31,74591,0,0,2021-01-01,AR,45565,2532689,17733,622481,63298,3155170
1422,2021-01-01,AR,274,422883,0,31,74591,0,0,2021-01-01,AR,36919,1453774,7238,424463,44157,1878237
1423,2021-01-01,AR,274,422883,0,31,74591,0,0,2021-01-01,AR,2374,1039694,476,141522,2850,1181216
1424,2021-01-01,AR,274,422883,0,31,74591,0,0,2021-01-01,AR,15805,518631,285,98925,16090,617556
1425,2021-01-01,AR,274,422883,0,31,74591,0,0,2021-01-01,AR,9493,143037,1080,44041,10573,187078
1426,2021-01-01,AR,274,422883,0,31,74591,0,0,2021-01-01,AR,279,39973,2317,16607,2596,56580
1427,2021-01-01,AR,274,422883,0,31,74591,0,0,2021-01-01,AR,15,6015,0,0,15,6015
1428,2021-01-01,AR,251,429637,0,25,75471,0,0,2021-01-01,AR,11303,5281234,17926,4317589,29229,9598823
1429,2021-01-01,AR,251,429637,0,25,75471,0,0,2021-01-01,AR,26586,4972904,11955,3764676,38541,8737580
1430,2021-01-01,AR,251,429637,0,25,75471,0,0,2021-01-01,AR,8797,4271166,36352,3291700,45149,7562866
1431,2021-01-01,AR,251,429637,0,25,75471,0,0,2021-01-01,AR,11272,4061715,52508,2244232,63780,6305947
1432,2021-01-01,AR,251,429637,0,25,75471,0,0,2021-01-01,AR,11204,3656428,13363,1048920,24567,4705348
1433,2021-01-01,AR,251,429637,0,25,75471,0,0,2021-01-01,AR,45565,2532689,17733,622481,63298,3155170
1434,2021-01-01,AR,251,429637,0,25,75471,0,0,2021-01-01,AR,36919,1453774,7238,424463,44157,1878237
1435,2021-01-01,AR,251,429637,0,25,75471,0,0,2021-01-01,AR,2374,1039694,476,141522,2850,1181216
1436,2021-01-01,AR,251,429637,0,25,75471,0,0,2021-01-01,AR,15805,518631,285,98925,16090,617556
1437,2021-01-01,AR,251,429637,0,25,75471,0,0,2021-01-01,AR,9493,143037,1080,44041,10573,187078
1438,2021-01-01,AR,251,429637,0,25,75471,0,0,2021-01-01,AR,279,39973,2317,16607,2596,56580
1439,2021-01-01,AR,251,429637,0,25,75471,0,0,2021-01-01,AR,15,6015,0,0,15,6015
1440,2021-01-26,AR,606,248250,0,130,40105,0,0,2021-01-26,AR,1406,5419136,2082,4622311,3488,10041447
1441,2021-01-26,AR,606,248250,0,130,40105,0,0,2021-01-26,AR,8492,5244204,22986,4234086,31478,9478290
1442,2021-01-26,AR,606,248250,0,130,40105,0,0,2021-01-26,AR,37708,4825812,21493,3700477,59201,8526289
1443,2021-01-26,AR,606,248250,0,130,40105,0,0,2021-01-26,AR,1801,4229885,9963,3120979,11764,7350864
1444,2021-01-26,AR,606,248250,0,130,40105,0,0,2021-01-26,AR,10274,4003964,51330,1990324,61604,5994288
1445,2021-01-26,AR,606,248250,0,130,40105,0,0,2021-01-26,AR,34408,3499836,22919,892844,57327,4392680
1446,2021-01-26,AR,606,248250,0,130,40105,0,0,2021-01-26,AR,33470,2325835,10459,581624,43929,2907459
1447,2021-01-26,AR,606,248250,0,130,40105,0,0,2021-01-26,AR,12702,1314924,9052,370168,21754,1685092
1448,2021-01-26,AR,606,248250,0,130,40105,0,0,2021-01-26,AR,23952,967021,793,128434,24745,1095455
1449,2021-01-26,AR,606,248250,0,130,40105,0,0,2021-01-26,AR,12412,427493,1495,96090,13907,523583
1450,2021-01-26,AR,606,248250,0,130,40105,0,0,2021-01-26,AR,9798,130897,1430,42631,11228,173528
1451,2021-01-26,AR,606,248250,0,130,40105,0,0,2021-01-26,AR,717,38689,1069,7043,1786,45732
1452,2021-01-30,AR,391,250250,0,76,40510,0,0,2021-01-30,AR,8293,5457136,13452,4686940,21745,10144076
1453,2021-01-30,AR,391,250250,0,76,40510,0,0,2021-01-30,AR,9714,5269931,23269,4299663,32983,9569594
1454,2021-01-30,AR,391,250250,0,76,40510,0,0,2021-01-30,AR,10026,4929511,5724,3749248,15750,8678759
1455,2021-01-30,AR,391,250250,0,76,40510,0,0,2021-01-30,AR,9476,4262369,39965,3255348,49441,7517717
1456,2021-01-30,AR,391,250250,0,76,40510,0,0,2021-01-30,AR,12839,4037168,46464,2140034,59303,6177202
1457,2021-01-30,AR,391,250250,0,76,40510,0,0,2021-01-30,AR,30958,3628241,29429,1013415,60387,4641656
1458,2021-01-30,AR,391,250250,0,76,40510,0,0,2021-01-30,AR,49110,2487124,5531,604748,54641,3091872
1459,2021-01-30,AR,391,250250,0,76,40510,0,0,2021-01-30,AR,15649,1382709,2346,408526,17995,1791235
1460,2021-01-30,AR,391,250250,0,76,40510,0,0,2021-01-30,AR,11694,1037320,4458,141046,16152,1178366
1461,2021-01-30,AR,391,250250,0,76,40510,0,0,2021-01-30,AR,22834,479095,719,97938,23553,577033
1462,2021-01-30,AR,391,250250,0,76,40510,0,0,2021-01-30,AR,20,39692,1148,14196,1168,53888
1463,2021-01-26,AR,438,262374,0,71,42899,0,0,2021-01-26,AR,1406,5419136,2082,4622311,3488,10041447
1464,2021-01-26,AR,438,262374,0,71,42899,0,0,2021-01-26,AR,8492,5244204,22986,4234086,31478,9478290
1465,2021-01-26,AR,438,262374,0,71,42899,0,0,2021-01-26,AR,37708,4825812,21493,3700477,59201,8526289
1466,2021-01-26,AR,438,262374,0,71,42899,0,0,2021-01-26,AR,1801,4229885,9963,3120979,11764,7350864
1467,2021-01-26,AR,438,262374,0,71,42899,0,0,2021-01-26,AR,10274,4003964,51330,1990324,61604,5994288
1468,2021-01-26,AR,438,262374,0,71,42899,0,0,2021-01-26,AR,34408,3499836,22919,892844,57327,4392680
1469,2021-01-26,AR,438,262374,0,71,42899,0,0,2021-01-26,AR,33470,2325835,10459,581624,43929,2907459
1470,2021-01-26,AR,438,262374,0,71,42899,0,0,2021-01-26,AR,12702,1314924,9052,370168,21754,1685092
1471,2021-01-26,AR,438,262374,0,71,42899,0,0,2021-01-26,AR,23952,967021,793,128434,24745,1095455
1472,2021-01-26,AR,438,262374,0,71,42899,0,0,2021-01-26,AR,12412,427493,1495,96090,13907,523583
1473,2021-01-26,AR,438,262374,0,71,42899,0,0,2021-01-26,AR,9798,130897,1430,42631,11228,173528
1474,2021-01-26,AR,438,262374,0,71,42899,0,0,2021-01-26,AR,717,38689,1069,7043,1786,45732
1475,2021-01-26,AR,553,275628,0,120,45473,0,0,2021-01-26,AR,1406,5419136,2082,4622311,3488,10041447
1476,2021-01-26,AR,553,275628,0,120,45473,0,0,2021-01-26,AR,8492,5244204,22986,4234086,31478,9478290
1477,2021-01-26,AR,553,275628,0,120,45473,0,0,2021-01-26,AR,37708,4825812,21493,3700477,59201,8526289
1478,2021-01-26,AR,553,275628,0,120,45473,0,0,2021-01-26,AR,1801,4229885,9963,3120979,11764,7350864
1479,2021-01-26,AR,553,275628,0,120,45473,0,0,2021-01-26,AR,10274,4003964,51330,1990324,61604,5994288
1480,2021-01-26,AR,553,275628,0,120,45473,0,0,2021-01-26,AR,34408,3499836,22919,892844,57327,4392680
1481,2021-01-26,AR,553,275628,0,120,45473,0,0,2021-01-26,AR,33470,2325835,10459,581624,43929,2907459
1482,2021-01-26,AR,553,275628,0,120,45473,0,0,2021-01-26,AR,12702,1314924,9052,370168,21754,1685092
1483,2021-01-26,AR,553,275628,0,120,45473,0,0,2021-01-26,AR,23952,967021,793,128434,24745,1095455
1484,2021-01-26,AR,553,275628,0,120,45473,0,0,2021-01-26,AR,12412,427493,1495,96090,13907,523583
1485,2021-01-26,AR,553,275628,0,120,45473,0,0,2021-01-26,AR,9798,130897,1430,42631,11228,173528
1486,2021-01-26,AR,553,275628,0,120,45473,0,0,2021-01-26,AR,717,38689,1069,7043,1786,45732
1487,2021-01-30,AR,613,277789,0,136,45916,0,0,2021-01-30,AR,8293,5457136,13452,4686940,21745,10144076
1488,2021-01-30,AR,613,277789,0,136,45916,0,0,2021-01-30,AR,9714,5269931,23269,4299663,32983,9569594
1489,2021-01-30,AR,613,277789,0,136,45916,0,0,2021-01-30,AR,10026,4929511,5724,3749248,15750,8678759
1490,2021-01-30,AR,613,277789,0,136,45916,0,0,2021-01-30,AR,9476,4262369,39965,3255348,49441,7517717
1491,2021-01-30,AR,613,277789,0,136,45916,0,0,2021-01-30,AR,12839,4037168,46464,2140034,59303,6177202
1492,2021-01-30,AR,613,277789,0,136,45916,0,0,2021-01-30,AR,30958,3628241,29429,1013415,60387,4641656
1493,2021-01-30,AR,613,277789,0,136,45916,0,0,2021-01-30,AR,49110,2487124,5531,604748,54641,3091872
1494,2021-01-30,AR,613,277789,0,136,45916,0,0,2021-01-30,AR,15649,1382709,2346,408526,17995,1791235
1495,2021-01-30,AR,613,277789,0,136,45916,0,0,2021-01-30,AR,11694,1037320,4458,141046,16152,1178366
1496,2021-01-30,AR,613,277789,0,136,45916,0,0,2021-01-30,AR,22834,479095,719,97938,23553,577033
1497,2021-01-30,AR,613,277789,0,136,45916,0,0,2021-01-30,AR,20,39692,1148,14196,1168,53888
1498,2021-01-26,AR,1016,300032,0,254,50555,0,0,2021-01-26,AR,1406,5419136,2082,4622311,3488,10041447
1499,2021-01-26,AR,1016,300032,0,254,50555,0,0,2021-01-26,AR,8492,5244204,22986,4234086,31478,9478290
1500,2021-01-26,AR,1016,300032,0,254,50555,0,0,2021-01-26,AR,37708,4825812,21493,3700477,59201,8526289
1501,2021-01-26,AR,1016,300032,0,254,50555,0,0,2021-01-26,AR,1801,4229885,9963,3120979,11764,7350864
1502,2021-01-26,AR,1016,300032,0,254,50555,0,0,2021-01-26,AR,10274,4003964,51330,1990324,61604,5994288
1503,2021-01-26,AR,1016,300032,0,254,50555,0,0,2021-01-26,AR,34408,3499836,22919,892844,57327,4392680
1504,2021-01-26,AR,1016,300032,0,254,50555,0,0,2021-01-26,AR,33470,2325835,10459,581624,43929,2907459
1505,2021-01-26,AR,1016,300032,0,254,50555,0,0,2021-01-26,AR,12702,1314924,9052,370168,21754,1685092
1506,2021-01-26,AR,1016,300032,0,254,50555,0,0,2021-01-26,AR,23952,967021,793,128434,24745,1095455
1507,2021-01-26,AR,1016,300032,0,254,50555,0,0,2021-01-26,AR,12412,427493,1495,96090,13907,523583
1508,2021-01-26,AR,1016,300032,0,254,50555,0,0,2021-01-26,AR,9798,130897,1430,42631,11228,173528
1509,2021-01-26,AR,1016,300032,0,254,50555,0,0,2021-01-26,AR,717,38689,1069,7043,1786,45732
1510,2021-01-30,AR,863,303762,0,189,51370,0,0,2021-01-30,AR,8293,5457136,13452,4686940,21745,10144076
1511,2021-01-30,AR,863,303762,0,189,51370,0,0,2021-01-30,AR,9714,5269931,23269,4299663,32983,9569594
1512,2021-01-30,AR,863,303762,0,189,51370,0,0,2021-01-30,AR,10026,4929511,5724,3749248,15750,8678759
1513,2021-01-30,AR,863,303762,0,189,51370,0,0,2021-01-30,AR,9476,4262369,39965,3255348,49441,7517717
1514,2021-01-30,AR,863,303762,0,189,51370,0,0,2021-01-30,AR,12839,4037168,46464,2140034,59303,6177202
1515,2021-01-30,AR,863,303762,0,189,51370,0,0,2021-01-30,AR,30958,3628241,29429,1013415,60387,4641656
1516,2021-01-30,AR,863,303762,0,189,51370,0,0,2021-01-30,AR,49110,2487124,5531,604748,54641,3091872
1517,2021-01-30,AR,863,303762,0,189,51370,0,0,2021-01-30,AR,15649,1382709,2346,408526,17995,1791235
1518,2021-01-30,AR,863,303762,0,189,51370,0,0,2021-01-30,AR,11694,1037320,4458,141046,16152,1178366
1519,2021-01-30,AR,863,303762,0,189,51370,0,0,2021-01-30,AR,22834,479095,719,97938,23553,577033
1520,2021-01-30,AR,863,303762,0,189,51370,0,0,2021-01-30,AR,20,39692,1148,14196,1168,53888
1521,2021-01-26,AR,1332,330131,0,252,57237,0,0,2021-01-26,AR,1406,5419136,2082,4622311,3488,10041447
1522,2021-01-26,AR,1332,330131,0,252,57237,0,0,2021-01-26,AR,8492,5244204,22986,4234086,31478,9478290
1523,2021-01-26,AR,1332,330131,0,252,57237,0,0,2021-01-26,AR,37708,4825812,21493,3700477,59201,8526289
1524,2021-01-26,AR,1332,330131,0,252,57237,0,0,2021-01-26,AR,1801,4229885,9963,3120979,11764,7350864
1525,2021-01-26,AR,1332,330131,0,252,57237,0,0,2021-01-26,AR,10274,4003964,51330,1990324,61604,5994288
1526,2021-01-26,AR,1332,330131,0,252,57237,0,0,2021-01-26,AR,34408,3499836,22919,892844,57327,4392680
1527,2021-01-26,AR,1332,330131,0,252,57237,0,0,2021-01-26,AR,33470,2325835,10459,581624,43929,2907459
1528,2021-01-26,AR,1332,330131,0,252,57237,0,0,2021-01-26,AR,12702,1314924,9052,370168,21754,1685092
1529,2021-01-26,AR,1332,330131,0,252,57237,0,0,2021-01-26,AR,23952,967021,793,128434,24745,1095455
1530,2021-01-26,AR,1332,330131,0,252,57237,0,0,2021-01-26,AR,12412,427493,1495,96090,13907,523583
1531,2021-01-26,AR,1332,330131,0,252,57237,0,0,2021-01-26,AR,9798,130897,1430,42631,11228,173528
1532,2021-01-26,AR,1332,330131,0,252,57237,0,0,2021-01-26,AR,717,38689,1069,7043,1786,45732
1533,2021-01-30,AR,1014,334850,0,271,58318,0,0,2021-01-30,AR,8293,5457136,13452,4686940,21745,10144076
1534,2021-01-30,AR,1014,334850,0,271,58318,0,0,2021-01-30,AR,9714,5269931,23269,4299663,32983,9569594
1535,2021-01-30,AR,1014,334850,0,271,58318,0,0,2021-01-30,AR,10026,4929511,5724,3749248,15750,8678759
1536,2021-01-30,AR,1014,334850,0,271,58318,0,0,2021-01-30,AR,9476,4262369,39965,3255348,49441,7517717
1537,2021-01-30,AR,1014,334850,0,271,58318,0,0,2021-01-30,AR,12839,4037168,46464,2140034,59303,6177202
1538,2021-01-30,AR,1014,334850,0,271,58318,0,0,2021-01-30,AR,30958,3628241,29429,1013415,60387,4641656
1539,2021-01-30,AR,1014,334850,0,271,58318,0,0,2021-01-30,AR,49110,2487124,5531,604748,54641,3091872
1540,2021-01-30,AR,1014,334850,0,271,58318,0,0,2021-01-30,AR,15649,1382709,2346,408526,17995,1791235
1541,2021-01-30,AR,1014,334850,0,271,58318,0,0,2021-01-30,AR,11694,1037320,4458,141046,16152,1178366
1542,2021-01-30,AR,1014,334850,0,271,58318,0,0,2021-01-30,AR,22834,479095,719,97938,23553,577033
1543,2021-01-30,AR,1014,334850,0,271,58318,0,0,2021-01-30,AR,20,39692,1148,14196,1168,53888
1544,2021-01-26,AR,785,362276,0,156,64345,0,0,2021-01-26,AR,1406,5419136,2082,4622311,3488,10041447
1545,2021-01-26,AR,785,362276,0,156,64345,0,0,2021-01-26,AR,8492,5244204,22986,4234086,31478,9478290
1546,2021-01-26,AR,785,362276,0,156,64345,0,0,2021-01-26,AR,37708,4825812,21493,3700477,59201,8526289
1547,2021-01-26,AR,785,362276,0,156,64345,0,0,2021-01-26,AR,1801,4229885,9963,3120979,11764,7350864
1548,2021-01-26,AR,785,362276,0,156,64345,0,0,2021-01-26,AR,10274,4003964,51330,1990324,61604,5994288
1549,2021-01-26,AR,785,362276,0,156,64345,0,0,2021-01-26,AR,34408,3499836,22919,892844,57327,4392680
1550,2021-01-26,AR,785,362276,0,156,64345,0,0,2021-01-26,AR,33470,2325835,10459,581624,43929,2907459
1551,2021-01-26,AR,785,362276,0,156,64345,0,0,2021-01-26,AR,12702,1314924,9052,370168,21754,1685092
1552,2021-01-26,AR,785,362276,0,156,64345,0,0,2021-01-26,AR,23952,967021,793,128434,24745,1095455
1553,2021-01-26,AR,785,362276,0,156,64345,0,0,2021-01-26,AR,12412,427493,1495,96090,13907,523583
1554,2021-01-26,AR,785,362276,0,156,64345,0,0,2021-01-26,AR,9798,130897,1430,42631,11228,173528
1555,2021-01-26,AR,785,362276,0,156,64345,0,0,2021-01-26,AR,717,38689,1069,7043,1786,45732
1556,2021-01-30,AR,955,365625,0,197,65061,0,0,2021-01-30,AR,8293,5457136,13452,4686940,21745,10144076
1557,2021-01-30,AR,955,365625,0,197,65061,0,0,2021-01-30,AR,9714,5269931,23269,4299663,32983,9569594
1558,2021-01-30,AR,955,365625,0,197,65061,0,0,2021-01-30,AR,10026,4929511,5724,3749248,15750,8678759
1559,2021-01-30,AR,955,365625,0,197,65061,0,0,2021-01-30,AR,9476,4262369,39965,3255348,49441,7517717
1560,2021-01-30,AR,955,365625,0,197,65061,0,0,2021-01-30,AR,12839,4037168,46464,2140034,59303,6177202
1561,2021-01-30,AR,955,365625,0,197,65061,0,0,2021-01-30,AR,30958,3628241,29429,1013415,60387,4641656
1562,2021-01-30,AR,955,365625,0,197,65061,0,0,2021-01-30,AR,49110,2487124,5531,604748,54641,3091872
1563,2021-01-30,AR,955,365625,0,197,65061,0,0,2021-01-30,AR,15649,1382709,2346,408526,17995,1791235
1564,2021-01-30,AR,955,365625,0,197,65061,0,0,2021-01-30,AR,11694,1037320,4458,141046,16152,1178366
1565,2021-01-30,AR,955,365625,0,197,65061,0,0,2021-01-30,AR,22834,479095,719,97938,23553,577033
1566,2021-01-30,AR,955,365625,0,197,65061,0,0,2021-01-30,AR,20,39692,1148,14196,1168,53888
1567,2021-01-26,AR,768,385224,0,139,68883,0,0,2021-01-26,AR,1406,5419136,2082,4622311,3488,10041447
1568,2021-01-26,AR,768,385224,0,139,68883,0,0,2021-01-26,AR,8492,5244204,22986,4234086,31478,9478290
1569,2021-01-26,AR,768,385224,0,139,68883,0,0,2021-01-26,AR,37708,4825812,21493,3700477,59201,8526289
1570,2021-01-26,AR,768,385224,0,139,68883,0,0,2021-01-26,AR,1801,4229885,9963,3120979,11764,7350864
1571,2021-01-26,AR,768,385224,0,139,68883,0,0,2021-01-26,AR,10274,4003964,51330,1990324,61604,5994288
1572,2021-01-26,AR,768,385224,0,139,68883,0,0,2021-01-26,AR,34408,3499836,22919,892844,57327,4392680
1573,2021-01-26,AR,768,385224,0,139,68883,0,0,2021-01-26,AR,33470,2325835,10459,581624,43929,2907459
1574,2021-01-26,AR,768,385224,0,139,68883,0,0,2021-01-26,AR,12702,1314924,9052,370168,21754,1685092
1575,2021-01-26,AR,768,385224,0,139,68883,0,0,2021-01-26,AR,23952,967021,793,128434,24745,1095455
1576,2021-01-26,AR,768,385224,0,139,68883,0,0,2021-01-26,AR,12412,427493,1495,96090,13907,523583
1577,2021-01-26,AR,768,385224,0,139,68883,0,0,2021-01-26,AR,9798,130897,1430,42631,11228,173528
1578,2021-01-26,AR,768,385224,0,139,68883,0,0,2021-01-26,AR,717,38689,1069,7043,1786,45732
1579,2021-01-30,AR,642,387787,0,117,69348,0,0,2021-01-30,AR,8293,5457136,13452,4686940,21745,10144076
1580,2021-01-30,AR,642,387787,0,117,69348,0,0,2021-01-30,AR,9714,5269931,23269,4299663,32983,9569594
1581,2021-01-30,AR,642,387787,0,117,69348,0,0,2021-01-30,AR,10026,4929511,5724,3749248,15750,8678759
1582,2021-01-30,AR,642,387787,0,117,69348,0,0,2021-01-30,AR,9476,4262369,39965,3255348,49441,7517717
1583,2021-01-30,AR,642,387787,0,117,69348,0,0,2021-01-30,AR,12839,4037168,46464,2140034,59303,6177202
1584,2021-01-30,AR,642,387787,0,117,69348,0,0,2021-01-30,AR,30958,3628241,29429,1013415,60387,4641656
1585,2021-01-30,AR,642,387787,0,117,69348,0,0,2021-01-30,AR,49110,2487124,5531,604748,54641,3091872
1586,2021-01-30,AR,642,387787,0,117,69348,0,0,2021-01-30,AR,15649,1382709,2346,408526,17995,1791235
1587,2021-01-30,AR,642,387787,0,117,69348,0,0,2021-01-30,AR,11694,1037320,4458,141046,16152,1178366
1588,2021-01-30,AR,642,387787,0,117,69348,0,0,2021-01-30,AR,22834,479095,719,97938,23553,577033
1589,2021-01-30,AR,642,387787,0,117,69348,0,0,2021-01-30,AR,20,39692,1148,14196,1168,53888
1590,2021-01-26,AR,449,402561,0,75,71984,0,0,2021-01-26,AR,1406,5419136,2082,4622311,3488,10041447
1591,2021-01-26,AR,449,402561,0,75,71984,0,0,2021-01-26,AR,8492,5244204,22986,4234086,31478,9478290
1592,2021-01-26,AR,449,402561,0,75,71984,0,0,2021-01-26,AR,37708,4825812,21493,3700477,59201,8526289
1593,2021-01-26,AR,449,402561,0,75,71984,0,0,2021-01-26,AR,1801,4229885,9963,3120979,11764,7350864
1594,2021-01-26,AR,449,402561,0,75,71984,0,0,2021-01-26,AR,10274,4003964,51330,1990324,61604,5994288
1595,2021-01-26,AR,449,402561,0,75,71984,0,0,2021-01-26,AR,34408,3499836,22919,892844,57327,4392680
1596,2021-01-26,AR,449,402561,0,75,71984,0,0,2021-01-26,AR,33470,2325835,10459,581624,43929,2907459
1597,2021-01-26,AR,449,402561,0,75,71984,0,0,2021-01-26,AR,12702,1314924,9052,370168,21754,1685092
1598,2021-01-26,AR,449,402561,0,75,71984,0,0,2021-01-26,AR,23952,967021,793,128434,24745,1095455
1599,2021-01-26,AR,449,402561,0,75,71984,0,0,2021-01-26,AR,12412,427493,1495,96090,13907,523583
1600,2021-01-26,AR,449,402561,0,75,71984,0,0,2021-01-26,AR,9798,130897,1430,42631,11228,173528
1601,2021-01-26,AR,449,402561,0,75,71984,0,0,2021-01-26,AR,717,38689,1069,7043,1786,45732
1602,2021-01-30,AR,561,404311,0,64,72238,0,0,2021-01-30,AR,8293,5457136,13452,4686940,21745,10144076
1603,2021-01-30,AR,561,404311,0,64,72238,0,0,2021-01-30,AR,9714,5269931,23269,4299663,32983,9569594
1604,2021-01-30,AR,561,404311,0,64,72238,0,0,2021-01-30,AR,10026,4929511,5724,3749248,15750,8678759
1605,2021-01-30,AR,561,404311,0,64,72238,0,0,2021-01-30,AR,9476,4262369,39965,3255348,49441,7517717
1606,2021-01-30,AR,561,404311,0,64,72238,0,0,2021-01-30,AR,12839,4037168,46464,2140034,59303,6177202
1607,2021-01-30,AR,561,404311,0,64,72238,0,0,2021-01-30,AR,30958,3628241,29429,1013415,60387,4641656
1608,2021-01-30,AR,561,404311,0,64,72238,0,0,2021-01-30,AR,49110,2487124,5531,604748,54641,3091872
1609,2021-01-30,AR,561,404311,0,64,72238,0,0,2021-01-30,AR,15649,1382709,2346,408526,17995,1791235
1610,2021-01-30,AR,561,404311,0,64,72238,0,0,2021-01-30,AR,11694,1037320,4458,141046,16152,1178366
1611,2021-01-30,AR,561,404311,0,64,72238,0,0,2021-01-30,AR,22834,479095,719,97938,23553,577033
1612,2021-01-30,AR,561,404311,0,64,72238,0,0,2021-01-30,AR,20,39692,1148,14196,1168,53888
1613,2021-01-26,AR,233,413633,0,29,73498,0,0,2021-01-26,AR,1406,5419136,2082,4622311,3488,10041447
1614,2021-01-26,AR,233,413633,0,29,73498,0,0,2021-01-26,AR,8492,5244204,22986,4234086,31478,9478290
1615,2021-01-26,AR,233,413633,0,29,73498,0,0,2021-01-26,AR,37708,4825812,21493,3700477,59201,8526289
1616,2021-01-26,AR,233,413633,0,29,73498,0,0,2021-01-26,AR,1801,4229885,9963,3120979,11764,7350864
1617,2021-01-26,AR,233,413633,0,29,73498,0,0,2021-01-26,AR,10274,4003964,51330,1990324,61604,5994288
1618,2021-01-26,AR,233,413633,0,29,73498,0,0,2021-01-26,AR,34408,3499836,22919,892844,57327,4392680
1619,2021-01-26,AR,233,413633,0,29,73498,0,0,2021-01-26,AR,33470,2325835,10459,581624,43929,2907459
1620,2021-01-26,AR,233,413633,0,29,73498,0,0,2021-01-26,AR,12702,1314924,9052,370168,21754,1685092
1621,2021-01-26,AR,233,413633,0,29,73498,0,0,2021-01-26,AR,23952,967021,793,128434,24745,1095455
1622,2021-01-26,AR,233,413633,0,29,73498,0,0,2021-01-26,AR,12412,427493,1495,96090,13907,523583
1623,2021-01-26,AR,233,413633,0,29,73498,0,0,2021-01-26,AR,9798,130897,1430,42631,11228,173528
1624,2021-01-26,AR,233,413633,0,29,73498,0,0,2021-01-26,AR,717,38689,1069,7043,1786,45732
1625,2021-01-30,AR,263,414797,0,41,73643,0,0,2021-01-30,AR,8293,5457136,13452,4686940,21745,10144076
1626,2021-01-30,AR,263,414797,0,41,73643,0,0,2021-01-30,AR,9714,5269931,23269,4299663,32983,9569594
1627,2021-01-30,AR,263,414797,0,41,73643,0,0,2021-01-30,AR,10026,4929511,5724,3749248,15750,8678759
1628,2021-01-30,AR,263,414797,0,41,73643,0,0,2021-01-30,AR,9476,4262369,39965,3255348,49441,7517717
1629,2021-01-30,AR,263,414797,0,41,73643,0,0,2021-01-30,AR,12839,4037168,46464,2140034,59303,6177202
1630,2021-01-30,AR,263,414797,0,41,73643,0,0,2021-01-30,AR,30958,3628241,29429,1013415,60387,4641656
1631,2021-01-30,AR,263,414797,0,41,73643,0,0,2021-01-30,AR,49110,2487124,5531,604748,54641,3091872
1632,2021-01-30,AR,263,414797,0,41,73643,0,0,2021-01-30,AR,15649,1382709,2346,408526,17995,1791235
1633,2021-01-30,AR,263,414797,0,41,73643,0,0,2021-01-30,AR,11694,1037320,4458,141046,16152,1178366
1634,2021-01-30,AR,263,414797,0,41,73643,0,0,2021-01-30,AR,22834,479095,719,97938,23553,577033
1635,2021-01-30,AR,263,414797,0,41,73643,0,0,2021-01-30,AR,20,39692,1148,14196,1168,53888
1636,2021-01-26,AR,293,421401,0,34,74434,0,0,2021-01-26,AR,1406,5419136,2082,4622311,3488,10041447
1637,2021-01-26,AR,293,421401,0,34,74434,0,0,2021-01-26,AR,8492,5244204,22986,4234086,31478,9478290
1638,2021-01-26,AR,293,421401,0,34,74434,0,0,2021-01-26,AR,37708,4825812,21493,3700477,59201,8526289
1639,2021-01-26,AR,293,421401,0,34,74434,0,0,2021-01-26,AR,1801,4229885,9963,3120979,11764,7350864
1640,2021-01-26,AR,293,421401,0,34,74434,0,0,2021-01-26,AR,10274,4003964,51330,1990324,61604,5994288
1641,2021-01-26,AR,293,421401,0,34,74434,0,0,2021-01-26,AR,34408,3499836,22919,892844,57327,4392680
1642,2021-01-26,AR,293,421401,0,34,74434,0,0,2021-01-26,AR,33470,2325835,10459,581624,43929,2907459
1643,2021-01-26,AR,293,421401,0,34,74434,0,0,2021-01-26,AR,12702,1314924,9052,370168,21754,1685092
1644,2021-01-26,AR,293,421401,0,34,74434,0,0,2021-01-26,AR,23952,967021,793,128434,24745,1095455
1645,2021-01-26,AR,293,421401,0,34,74434,0,0,2021-01-26,AR,12412,427493,1495,96090,13907,523583
1646,2021-01-26,AR,293,421401,0,34,74434,0,0,2021-01-26,AR,9798,130897,1430,42631,11228,173528
1647,2021-01-26,AR,293,421401,0,34,74434,0,0,2021-01-26,AR,717,38689,1069,7043,1786,45732
1648,2021-01-30,AR,204,422412,0,17,74545,0,0,2021-01-30,AR,8293,5457136,13452,4686940,21745,10144076
1649,2021-01-30,AR,204,422412,0,17,74545,0,0,2021-01-30,AR,9714,5269931,23269,4299663,32983,9569594
1650,2021-01-30,AR,204,422412,0,17,74545,0,0,2021-01-30,AR,10026,4929511,5724,3749248,15750,8678759
1651,2021-01-30,AR,204,422412,0,17,74545,0,0,2021-01-30,AR,9476,4262369,39965,3255348,49441,7517717
1652,2021-01-30,AR,204,422412,0,17,74545,0,0,2021-01-30,AR,12839,4037168,46464,2140034,59303,6177202
1653,2021-01-30,AR,204,422412,0,17,74545,0,0,2021-01-30,AR,30958,3628241,29429,1013415,60387,4641656
1654,2021-01-30,AR,204,422412,0,17,74545,0,0,2021-01-30,AR,49110,2487124,5531,604748,54641,3091872
1655,2021-01-30,AR,204,422412,0,17,74545,0,0,2021-01-30,AR,15649,1382709,2346,408526,17995,1791235
1656,2021-01-30,AR,204,422412,0,17,74545,0,0,2021-01-30,AR,11694,1037320,4458,141046,16152,1178366
1657,2021-01-30,AR,204,422412,0,17,74545,0,0,2021-01-30,AR,22834,479095,719,97938,23553,577033
1658,2021-01-30,AR,204,422412,0,17,74545,0,0,2021-01-30,AR,20,39692,1148,14196,1168,53888
1659,2021-01-26,AR,220,428489,0,27,75316,0,0,2021-01-26,AR,1406,5419136,2082,4622311,3488,10041447
1660,2021-01-26,AR,220,428489,0,27,75316,0,0,2021-01-26,AR,8492,5244204,22986,4234086,31478,9478290
1661,2021-01-26,AR,220,428489,0,27,75316,0,0,2021-01-26,AR,37708,4825812,21493,3700477,59201,8526289
1662,2021-01-26,AR,220,428489,0,27,75316,0,0,2021-01-26,AR,1801,4229885,9963,3120979,11764,7350864
1663,2021-01-26,AR,220,428489,0,27,75316,0,0,2021-01-26,AR,10274,4003964,51330,1990324,61604,5994288
1664,2021-01-26,AR,220,428489,0,27,75316,0,0,2021-01-26,AR,34408,3499836,22919,892844,57327,4392680
1665,2021-01-26,AR,220,428489,0,27,75316,0,0,2021-01-26,AR,33470,2325835,10459,581624,43929,2907459
1666,2021-01-26,AR,220,428489,0,27,75316,0,0,2021-01-26,AR,12702,1314924,9052,370168,21754,1685092
1667,2021-01-26,AR,220,428489,0,27,75316,0,0,2021-01-26,AR,23952,967021,793,128434,24745,1095455
1668,2021-01-26,AR,220,428489,0,27,75316,0,0,2021-01-26,AR,12412,427493,1495,96090,13907,523583
1669,2021-01-26,AR,220,428489,0,27,75316,0,0,2021-01-26,AR,9798,130897,1430,42631,11228,173528
1670,2021-01-26,AR,220,428489,0,27,75316,0,0,2021-01-26,AR,717,38689,1069,7043,1786,45732
1671,2021-01-30,AR,268,429386,0,31,75446,0,0,2021-01-30,AR,8293,5457136,13452,4686940,21745,10144076
1672,2021-01-30,AR,268,429386,0,31,75446,0,0,2021-01-30,AR,9714,5269931,23269,4299663,32983,9569594
1673,2021-01-30,AR,268,429386,0,31,75446,0,0,2021-01-30,AR,10026,4929511,5724,3749248,15750,8678759
1674,2021-01-30,AR,268,429386,0,31,75446,0,0,2021-01-30,AR,9476,4262369,39965,3255348,49441,7517717
1675,2021-01-30,AR,268,429386,0,31,75446,0,0,2021-01-30,AR,12839,4037168,46464,2140034,59303,6177202
1676,2021-01-30,AR,268,429386,0,31,75446,0,0,2021-01-30,AR,30958,3628241,29429,1013415,60387,4641656
1677,2021-01-30,AR,268,429386,0,31,75446,0,0,2021-01-30,AR,49110,2487124,5531,604748,54641,3091872
1678,2021-01-30,AR,268,429386,0,31,75446,0,0,2021-01-30,AR,15649,1382709,2346,408526,17995,1791235
1679,2021-01-30,AR,268,429386,0,31,75446,0,0,2021-01-30,AR,11694,1037320,4458,141046,16152,1178366
1680,2021-01-30,AR,268,429386,0,31,75446,0,0,2021-01-30,AR,22834,479095,719,97938,23553,577033
1681,2021-01-30,AR,268,429386,0,31,75446,0,0,2021-01-30,AR,20,39692,1148,14196,1168,53888
1682,2021-01-26,AR,254,435086,0,31,76283,0,0,2021-01-26,AR,1406,5419136,2082,4622311,3488,10041447
1683,2021-01-26,AR,254,435086,0,31,76283,0,0,2021-01-26,AR,8492,5244204,22986,4234086,31478,9478290
1684,2021-01-26,AR,254,435086,0,31,76283,0,0,2021-01-26,AR,37708,4825812,21493,3700477,59201,8526289
1685,2021-01-26,AR,254,435086,0,31,76283,0,0,2021-01-26,AR,1801,4229885,9963,3120979,11764,7350864
1686,2021-01-26,AR,254,435086,0,31,76283,0,0,2021-01-26,AR,10274,4003964,51330,1990324,61604,5994288
1687,2021-01-26,AR,254,435086,0,31,76283,0,0,2021-01-26,AR,34408,3499836,22919,892844,57327,4392680
1688,2021-01-26,AR,254,435086,0,31,76283,0,0,2021-01-26,AR,33470,2325835,10459,581624,43929,2907459
1689,2021-01-26,AR,254,435086,0,31,76283,0,0,2021-01-26,AR,12702,1314924,9052,370168,21754,1685092
1690,2021-01-26,AR,254,435086,0,31,76283,0,0,2021-01-26,AR,23952,967021,793,128434,24745,1095455
1691,2021-01-26,AR,254,435086,0,31,76283,0,0,2021-01-26,AR,12412,427493,1495,96090,13907,523583
1692,2021-01-26,AR,254,435086,0,31,76283,0,0,2021-01-26,AR,9798,130897,1430,42631,11228,173528
1693,2021-01-26,AR,254,435086,0,31,76283,0,0,2021-01-26,AR,717,38689,1069,7043,1786,45732
1694,2021-01-30,AR,336,436545,0,61,76517,0,0,2021-01-30,AR,8293,5457136,13452,4686940,21745,10144076
1695,2021-01-30,AR,336,436545,0,61,76517,0,0,2021-01-30,AR,9714,5269931,23269,4299663,32983,9569594
1696,2021-01-30,AR,336,436545,0,61,76517,0,0,2021-01-30,AR,10026,4929511,5724,3749248,15750,8678759
1697,2021-01-30,AR,336,436545,0,61,76517,0,0,2021-01-30,AR,9476,4262369,39965,3255348,49441,7517717
1698,2021-01-30,AR,336,436545,0,61,76517,0,0,2021-01-30,AR,12839,4037168,46464,2140034,59303,6177202
1699,2021-01-30,AR,336,436545,0,61,76517,0,0,2021-01-30,AR,30958,3628241,29429,1013415,60387,4641656
1700,2021-01-30,AR,336,436545,0,61,76517,0,0,2021-01-30,AR,49110,2487124,5531,604748,54641,3091872
1701,2021-01-30,AR,336,436545,0,61,76517,0,0,2021-01-30,AR,15649,1382709,2346,408526,17995,1791235
1702,2021-01-30,AR,336,436545,0,61,76517,0,0,2021-01-30,AR,11694,1037320,4458,141046,16152,1178366
1703,2021-01-30,AR,336,436545,0,61,76517,0,0,2021-01-30,AR,22834,479095,719,97938,23553,577033
1704,2021-01-30,AR,336,436545,0,61,76517,0,0,2021-01-30,AR,20,39692,1148,14196,1168,53888
1705,2021-01-07,AR,649,237403,0,100,38003,0,0,2021-01-07,AR,9335,5327045,23280,4418054,32615,9745099
1706,2021-01-07,AR,649,237403,0,100,38003,0,0,2021-01-07,AR,8427,5074187,7538,3864045,15965,8938232
1707,2021-01-07,AR,649,237403,0,100,38003,0,0,2021-01-07,AR,11780,4323152,23895,3425012,35675,7748164
1708,2021-01-07,AR,649,237403,0,100,38003,0,0,2021-01-07,AR,7631,4105005,57703,2526965,65334,6631970
1709,2021-01-07,AR,649,237403,0,100,38003,0,0,2021-01-07,AR,10474,3788371,29384,1256613,39858,5044984
1710,2021-01-07,AR,649,237403,0,100,38003,0,0,2021-01-07,AR,40528,2751626,15955,708743,56483,3460369
1711,2021-01-07,AR,649,237403,0,100,38003,0,0,2021-01-07,AR,42783,1703275,6805,453936,49588,2157211
1712,2021-01-07,AR,649,237403,0,100,38003,0,0,2021-01-07,AR,15609,1132796,13659,201041,29268,1333837
1713,2021-01-07,AR,649,237403,0,100,38003,0,0,2021-01-07,AR,33903,626848,985,102839,34888,729687
1714,2021-01-07,AR,649,237403,0,100,38003,0,0,2021-01-07,AR,1646,197932,16,50434,1662,248366
1715,2021-01-07,AR,649,237403,0,100,38003,0,0,2021-01-07,AR,68,46020,111,28039,179,74059
1716,2021-01-07,AR,649,237403,0,100,38003,0,0,2021-01-07,AR,2483,13390,2,3,2485,13393
1717,2021-01-07,AR,399,254018,0,70,41303,0,0,2021-01-07,AR,9335,5327045,23280,4418054,32615,9745099
1718,2021-01-07,AR,399,254018,0,70,41303,0,0,2021-01-07,AR,8427,5074187,7538,3864045,15965,8938232
1719,2021-01-07,AR,399,254018,0,70,41303,0,0,2021-01-07,AR,11780,4323152,23895,3425012,35675,7748164
1720,2021-01-07,AR,399,254018,0,70,41303,0,0,2021-01-07,AR,7631,4105005,57703,2526965,65334,6631970
1721,2021-01-07,AR,399,254018,0,70,41303,0,0,2021-01-07,AR,10474,3788371,29384,1256613,39858,5044984
1722,2021-01-07,AR,399,254018,0,70,41303,0,0,2021-01-07,AR,40528,2751626,15955,708743,56483,3460369
1723,2021-01-07,AR,399,254018,0,70,41303,0,0,2021-01-07,AR,42783,1703275,6805,453936,49588,2157211
1724,2021-01-07,AR,399,254018,0,70,41303,0,0,2021-01-07,AR,15609,1132796,13659,201041,29268,1333837
1725,2021-01-07,AR,399,254018,0,70,41303,0,0,2021-01-07,AR,33903,626848,985,102839,34888,729687
1726,2021-01-07,AR,399,254018,0,70,41303,0,0,2021-01-07,AR,1646,197932,16,50434,1662,248366
1727,2021-01-07,AR,399,254018,0,70,41303,0,0,2021-01-07,AR,68,46020,111,28039,179,74059
1728,2021-01-07,AR,399,254018,0,70,41303,0,0,2021-01-07,AR,2483,13390,2,3,2485,13393
1729,2021-01-07,AR,330,266341,0,72,43606,0,0,2021-01-07,AR,9335,5327045,23280,4418054,32615,9745099
1730,2021-01-07,AR,330,266341,0,72,43606,0,0,2021-01-07,AR,8427,5074187,7538,3864045,15965,8938232
1731,2021-01-07,AR,330,266341,0,72,43606,0,0,2021-01-07,AR,11780,4323152,23895,3425012,35675,7748164
1732,2021-01-07,AR,330,266341,0,72,43606,0,0,2021-01-07,AR,7631,4105005,57703,2526965,65334,6631970
1733,2021-01-07,AR,330,266341,0,72,43606,0,0,2021-01-07,AR,10474,3788371,29384,1256613,39858,5044984
1734,2021-01-07,AR,330,266341,0,72,43606,0,0,2021-01-07,AR,40528,2751626,15955,708743,56483,3460369
1735,2021-01-07,AR,330,266341,0,72,43606,0,0,2021-01-07,AR,42783,1703275,6805,453936,49588,2157211
1736,2021-01-07,AR,330,266341,0,72,43606,0,0,2021-01-07,AR,15609,1132796,13659,201041,29268,1333837
1737,2021-01-07,AR,330,266341,0,72,43606,0,0,2021-01-07,AR,33903,626848,985,102839,34888,729687
1738,2021-01-07,AR,330,266341,0,72,43606,0,0,2021-01-07,AR,1646,197932,16,50434,1662,248366
1739,2021-01-07,AR,330,266341,0,72,43606,0,0,2021-01-07,AR,68,46020,111,28039,179,74059
1740,2021-01-07,AR,330,266341,0,72,43606,0,0,2021-01-07,AR,2483,13390,2,3,2485,13393
1741,2021-01-07,AR,798,283021,0,159,47011,0,0,2021-01-07,AR,9335,5327045,23280,4418054,32615,9745099
1742,2021-01-07,AR,798,283021,0,159,47011,0,0,2021-01-07,AR,8427,5074187,7538,3864045,15965,8938232
1743,2021-01-07,AR,798,283021,0,159,47011,0,0,2021-01-07,AR,11780,4323152,23895,3425012,35675,7748164
1744,2021-01-07,AR,798,283021,0,159,47011,0,0,2021-01-07,AR,7631,4105005,57703,2526965,65334,6631970
1745,2021-01-07,AR,798,283021,0,159,47011,0,0,2021-01-07,AR,10474,3788371,29384,1256613,39858,5044984
1746,2021-01-07,AR,798,283021,0,159,47011,0,0,2021-01-07,AR,40528,2751626,15955,708743,56483,3460369
1747,2021-01-07,AR,798,283021,0,159,47011,0,0,2021-01-07,AR,42783,1703275,6805,453936,49588,2157211
1748,2021-01-07,AR,798,283021,0,159,47011,0,0,2021-01-07,AR,15609,1132796,13659,201041,29268,1333837
1749,2021-01-07,AR,798,283021,0,159,47011,0,0,2021-01-07,AR,33903,626848,985,102839,34888,729687
1750,2021-01-07,AR,798,283021,0,159,47011,0,0,2021-01-07,AR,1646,197932,16,50434,1662,248366
1751,2021-01-07,AR,798,283021,0,159,47011,0,0,2021-01-07,AR,68,46020,111,28039,179,74059
1752,2021-01-07,AR,798,283021,0,159,47011,0,0,2021-01-07,AR,2483,13390,2,3,2485,13393
1753,2021-01-07,AR,934,310006,0,206,52779,0,0,2021-01-07,AR,9335,5327045,23280,4418054,32615,9745099
1754,2021-01-07,AR,934,310006,0,206,52779,0,0,2021-01-07,AR,8427,5074187,7538,3864045,15965,8938232
1755,2021-01-07,AR,934,310006,0,206,52779,0,0,2021-01-07,AR,11780,4323152,23895,3425012,35675,7748164
1756,2021-01-07,AR,934,310006,0,206,52779,0,0,2021-01-07,AR,7631,4105005,57703,2526965,65334,6631970
1757,2021-01-07,AR,934,310006,0,206,52779,0,0,2021-01-07,AR,10474,3788371,29384,1256613,39858,5044984
1758,2021-01-07,AR,934,310006,0,206,52779,0,0,2021-01-07,AR,40528,2751626,15955,708743,56483,3460369
1759,2021-01-07,AR,934,310006,0,206,52779,0,0,2021-01-07,AR,42783,1703275,6805,453936,49588,2157211
1760,2021-01-07,AR,934,310006,0,206,52779,0,0,2021-01-07,AR,15609,1132796,13659,201041,29268,1333837
1761,2021-01-07,AR,934,310006,0,206,52779,0,0,2021-01-07,AR,33903,626848,985,102839,34888,729687
1762,2021-01-07,AR,934,310006,0,206,52779,0,0,2021-01-07,AR,1646,197932,16,50434,1662,248366
1763,2021-01-07,AR,934,310006,0,206,52779,0,0,2021-01-07,AR,68,46020,111,28039,179,74059
1764,2021-01-07,AR,934,310006,0,206,52779,0,0,2021-01-07,AR,2483,13390,2,3,2485,13393
1765,2021-01-07,AR,1181,344306,0,247,60391,0,0,2021-01-07,AR,9335,5327045,23280,4418054,32615,9745099
1766,2021-01-07,AR,1181,344306,0,247,60391,0,0,2021-01-07,AR,8427,5074187,7538,3864045,15965,8938232
1767,2021-01-07,AR,1181,344306,0,247,60391,0,0,2021-01-07,AR,11780,4323152,23895,3425012,35675,7748164
1768,2021-01-07,AR,1181,344306,0,247,60391,0,0,2021-01-07,AR,7631,4105005,57703,2526965,65334,6631970
1769,2021-01-07,AR,1181,344306,0,247,60391,0,0,2021-01-07,AR,10474,3788371,29384,1256613,39858,5044984
1770,2021-01-07,AR,1181,344306,0,247,60391,0,0,2021-01-07,AR,40528,2751626,15955,708743,56483,3460369
1771,2021-01-07,AR,1181,344306,0,247,60391,0,0,2021-01-07,AR,42783,1703275,6805,453936,49588,2157211
1772,2021-01-07,AR,1181,344306,0,247,60391,0,0,2021-01-07,AR,15609,1132796,13659,201041,29268,1333837
1773,2021-01-07,AR,1181,344306,0,247,60391,0,0,2021-01-07,AR,33903,626848,985,102839,34888,729687
1774,2021-01-07,AR,1181,344306,0,247,60391,0,0,2021-01-07,AR,1646,197932,16,50434,1662,248366
1775,2021-01-07,AR,1181,344306,0,247,60391,0,0,2021-01-07,AR,68,46020,111,28039,179,74059
1776,2021-01-07,AR,1181,344306,0,247,60391,0,0,2021-01-07,AR,2483,13390,2,3,2485,13393
1777,2021-01-07,AR,891,371426,0,173,66214,0,0,2021-01-07,AR,9335,5327045,23280,4418054,32615,9745099
1778,2021-01-07,AR,891,371426,0,173,66214,0,0,2021-01-07,AR,8427,5074187,7538,3864045,15965,8938232
1779,2021-01-07,AR,891,371426,0,173,66214,0,0,2021-01-07,AR,11780,4323152,23895,3425012,35675,7748164
1780,2021-01-07,AR,891,371426,0,173,66214,0,0,2021-01-07,AR,7631,4105005,57703,2526965,65334,6631970
1781,2021-01-07,AR,891,371426,0,173,66214,0,0,2021-01-07,AR,10474,3788371,29384,1256613,39858,5044984
1782,2021-01-07,AR,891,371426,0,173,66214,0,0,2021-01-07,AR,40528,2751626,15955,708743,56483,3460369
1783,2021-01-07,AR,891,371426,0,173,66214,0,0,2021-01-07,AR,42783,1703275,6805,453936,49588,2157211
1784,2021-01-07,AR,891,371426,0,173,66214,0,0,2021-01-07,AR,15609,1132796,13659,201041,29268,1333837
1785,2021-01-07,AR,891,371426,0,173,66214,0,0,2021-01-07,AR,33903,626848,985,102839,34888,729687
1786,2021-01-07,AR,891,371426,0,173,66214,0,0,2021-01-07,AR,1646,197932,16,50434,1662,248366
1787,2021-01-07,AR,891,371426,0,173,66214,0,0,2021-01-07,AR,68,46020,111,28039,179,74059
1788,2021-01-07,AR,891,371426,0,173,66214,0,0,2021-01-07,AR,2483,13390,2,3,2485,13393
1789,2021-01-07,AR,538,392704,0,106,70279,0,0,2021-01-07,AR,9335,5327045,23280,4418054,32615,9745099
1790,2021-01-07,AR,538,392704,0,106,70279,0,0,2021-01-07,AR,8427,5074187,7538,3864045,15965,8938232
1791,2021-01-07,AR,538,392704,0,106,70279,0,0,2021-01-07,AR,11780,4323152,23895,3425012,35675,7748164
1792,2021-01-07,AR,538,392704,0,106,70279,0,0,2021-01-07,AR,7631,4105005,57703,2526965,65334,6631970
1793,2021-01-07,AR,538,392704,0,106,70279,0,0,2021-01-07,AR,10474,3788371,29384,1256613,39858,5044984
1794,2021-01-07,AR,538,392704,0,106,70279,0,0,2021-01-07,AR,40528,2751626,15955,708743,56483,3460369
1795,2021-01-07,AR,538,392704,0,106,70279,0,0,2021-01-07,AR,42783,1703275,6805,453936,49588,2157211
1796,2021-01-07,AR,538,392704,0,106,70279,0,0,2021-01-07,AR,15609,1132796,13659,201041,29268,1333837
1797,2021-01-07,AR,538,392704,0,106,70279,0,0,2021-01-07,AR,33903,626848,985,102839,34888,729687
1798,2021-01-07,AR,538,392704,0,106,70279,0,0,2021-01-07,AR,1646,197932,16,50434,1662,248366
1799,2021-01-07,AR,538,392704,0,106,70279,0,0,2021-01-07,AR,68,46020,111,28039,179,74059
1800,2021-01-07,AR,538,392704,0,106,70279,0,0,2021-01-07,AR,2483,13390,2,3,2485,13393
1801,2021-01-07,AR,392,407545,0,65,72728,0,0,2021-01-07,AR,9335,5327045,23280,4418054,32615,9745099
1802,2021-01-07,AR,392,407545,0,65,72728,0,0,2021-01-07,AR,8427,5074187,7538,3864045,15965,8938232
1803,2021-01-07,AR,392,407545,0,65,72728,0,0,2021-01-07,AR,11780,4323152,23895,3425012,35675,7748164
1804,2021-01-07,AR,392,407545,0,65,72728,0,0,2021-01-07,AR,7631,4105005,57703,2526965,65334,6631970
1805,2021-01-07,AR,392,407545,0,65,72728,0,0,2021-01-07,AR,10474,3788371,29384,1256613,39858,5044984
1806,2021-01-07,AR,392,407545,0,65,72728,0,0,2021-01-07,AR,40528,2751626,15955,708743,56483,3460369
1807,2021-01-07,AR,392,407545,0,65,72728,0,0,2021-01-07,AR,42783,1703275,6805,453936,49588,2157211
1808,2021-01-07,AR,392,407545,0,65,72728,0,0,2021-01-07,AR,15609,1132796,13659,201041,29268,1333837
1809,2021-01-07,AR,392,407545,0,65,72728,0,0,2021-01-07,AR,33903,626848,985,102839,34888,729687
1810,2021-01-07,AR,392,407545,0,65,72728,0,0,2021-01-07,AR,1646,197932,16,50434,1662,248366
1811,2021-01-07,AR,392,407545,0,65,72728,0,0,2021-01-07,AR,68,46020,111,28039,179,74059
1812,2021-01-07,AR,392,407545,0,65,72728,0,0,2021-01-07,AR,2483,13390,2,3,2485,13393
1813,2021-01-07,AR,226,416651,0,24,73861,0,0,2021-01-07,AR,9335,5327045,23280,4418054,32615,9745099
1814,2021-01-07,AR,226,416651,0,24,73861,0,0,2021-01-07,AR,8427,5074187,7538,3864045,15965,8938232
1815,2021-01-07,AR,226,416651,0,24,73861,0,0,2021-01-07,AR,11780,4323152,23895,3425012,35675,7748164
1816,2021-01-07,AR,226,416651,0,24,73861,0,0,2021-01-07,AR,7631,4105005,57703,2526965,65334,6631970
1817,2021-01-07,AR,226,416651,0,24,73861,0,0,2021-01-07,AR,10474,3788371,29384,1256613,39858,5044984
1818,2021-01-07,AR,226,416651,0,24,73861,0,0,2021-01-07,AR,40528,2751626,15955,708743,56483,3460369
1819,2021-01-07,AR,226,416651,0,24,73861,0,0,2021-01-07,AR,42783,1703275,6805,453936,49588,2157211
1820,2021-01-07,AR,226,416651,0,24,73861,0,0,2021-01-07,AR,15609,1132796,13659,201041,29268,1333837
1821,2021-01-07,AR,226,416651,0,24,73861,0,0,2021-01-07,AR,33903,626848,985,102839,34888,729687
1822,2021-01-07,AR,226,416651,0,24,73861,0,0,2021-01-07,AR,1646,197932,16,50434,1662,248366
1823,2021-01-07,AR,226,416651,0,24,73861,0,0,2021-01-07,AR,68,46020,111,28039,179,74059
1824,2021-01-07,AR,226,416651,0,24,73861,0,0,2021-01-07,AR,2483,13390,2,3,2485,13393
1825,2021-01-07,AR,164,424183,0,23,74756,0,0,2021-01-07,AR,9335,5327045,23280,4418054,32615,9745099
1826,2021-01-07,AR,164,424183,0,23,74756,0,0,2021-01-07,AR,8427,5074187,7538,3864045,15965,8938232
1827,2021-01-07,AR,164,424183,0,23,74756,0,0,2021-01-07,AR,11780,4323152,23895,3425012,35675,7748164
1828,2021-01-07,AR,164,424183,0,23,74756,0,0,2021-01-07,AR,7631,4105005,57703,2526965,65334,6631970
1829,2021-01-07,AR,164,424183,0,23,74756,0,0,2021-01-07,AR,10474,3788371,29384,1256613,39858,5044984
1830,2021-01-07,AR,164,424183,0,23,74756,0,0,2021-01-07,AR,40528,2751626,15955,708743,56483,3460369
1831,2021-01-07,AR,164,424183,0,23,74756,0,0,2021-01-07,AR,42783,1703275,6805,453936,49588,2157211
1832,2021-01-07,AR,164,424183,0,23,74756,0,0,2021-01-07,AR,15609,1132796,13659,201041,29268,1333837
1833,2021-01-07,AR,164,424183,0,23,74756,0,0,2021-01-07,AR,33903,626848,985,102839,34888,729687
1834,2021-01-07,AR,164,424183,0,23,74756,0,0,2021-01-07,AR,1646,197932,16,50434,1662,248366
1835,2021-01-07,AR,164,424183,0,23,74756,0,0,2021-01-07,AR,68,46020,111,28039,179,74059
1836,2021-01-07,AR,164,424183,0,23,74756,0,0,2021-01-07,AR,2483,13390,2,3,2485,13393
1837,2021-01-07,AR,226,430920,0,34,75648,0,0,2021-01-07,AR,9335,5327045,23280,4418054,32615,9745099
1838,2021-01-07,AR,226,430920,0,34,75648,0,0,2021-01-07,AR,8427,5074187,7538,3864045,15965,8938232
1839,2021-01-07,AR,226,430920,0,34,75648,0,0,2021-01-07,AR,11780,4323152,23895,3425012,35675,7748164
1840,2021-01-07,AR,226,430920,0,34,75648,0,0,2021-01-07,AR,7631,4105005,57703,2526965,65334,6631970
1841,2021-01-07,AR,226,430920,0,34,75648,0,0,2021-01-07,AR,10474,3788371,29384,1256613,39858,5044984
1842,2021-01-07,AR,226,430920,0,34,75648,0,0,2021-01-07,AR,40528,2751626,15955,708743,56483,3460369
1843,2021-01-07,AR,226,430920,0,34,75648,0,0,2021-01-07,AR,42783,1703275,6805,453936,49588,2157211
1844,2021-01-07,AR,226,430920,0,34,75648,0,0,2021-01-07,AR,15609,1132796,13659,201041,29268,1333837
1845,2021-01-07,AR,226,430920,0,34,75648,0,0,2021-01-07,AR,33903,626848,985,102839,34888,729687
1846,2021-01-07,AR,226,430920,0,34,75648,0,0,2021-01-07,AR,1646,197932,16,50434,1662,248366
1847,2021-01-07,AR,226,430920,0,34,75648,0,0,2021-01-07,AR,68,46020,111,28039,179,74059
1848,2021-01-07,AR,226,430920,0,34,75648,0,0,2021-01-07,AR,2483,13390,2,3,2485,13393
1849,2021-01-03,AR,504,234665,0,89,37557,0,0,2021-01-03,AR,9468,5301432,18076,4358185,27544,9659617
1850,2021-01-03,AR,504,234665,0,89,37557,0,0,2021-01-03,AR,20785,5012390,22576,3808023,43361,8820413
1851,2021-01-03,AR,504,234665,0,89,37557,0,0,2021-01-03,AR,2941,4278045,12967,3328046,15908,7606091
1852,2021-01-03,AR,504,234665,0,89,37557,0,0,2021-01-03,AR,9145,4081968,52498,2348462,61643,6430430
1853,2021-01-03,AR,504,234665,0,89,37557,0,0,2021-01-03,AR,29869,3711593,28367,1111866,58236,4823459
1854,2021-01-03,AR,504,234665,0,89,37557,0,0,2021-01-03,AR,35220,2616956,11966,646445,47186,3263401
1855,2021-01-03,AR,504,234665,0,89,37557,0,0,2021-01-03,AR,44893,1534631,4931,436685,49824,1971316
1856,2021-01-03,AR,504,234665,0,89,37557,0,0,2021-01-03,AR,13128,1056262,10562,153871,23690,1210133
1857,2021-01-03,AR,504,234665,0,89,37557,0,0,2021-01-03,AR,10474,538513,80,99115,10554,637628
1858,2021-01-03,AR,504,234665,0,89,37557,0,0,2021-01-03,AR,8883,161385,1026,46080,9909,207465
1859,2021-01-03,AR,504,234665,0,89,37557,0,0,2021-01-03,AR,1459,42143,2356,21554,3815,63697
1860,2021-01-03,AR,504,234665,0,89,37557,0,0,2021-01-03,AR,52,6477,0,0,52,6477
1861,2021-01-03,AR,572,252236,0,108,40913,0,0,2021-01-03,AR,9468,5301432,18076,4358185,27544,9659617
1862,2021-01-03,AR,572,252236,0,108,40913,0,0,2021-01-03,AR,20785,5012390,22576,3808023,43361,8820413
1863,2021-01-03,AR,572,252236,0,108,40913,0,0,2021-01-03,AR,2941,4278045,12967,3328046,15908,7606091
1864,2021-01-03,AR,572,252236,0,108,40913,0,0,2021-01-03,AR,9145,4081968,52498,2348462,61643,6430430
1865,2021-01-03,AR,572,252236,0,108,40913,0,0,2021-01-03,AR,29869,3711593,28367,1111866,58236,4823459
1866,2021-01-03,AR,572,252236,0,108,40913,0,0,2021-01-03,AR,35220,2616956,11966,646445,47186,3263401
1867,2021-01-03,AR,572,252236,0,108,40913,0,0,2021-01-03,AR,44893,1534631,4931,436685,49824,1971316
1868,2021-01-03,AR,572,252236,0,108,40913,0,0,2021-01-03,AR,13128,1056262,10562,153871,23690,1210133
1869,2021-01-03,AR,572,252236,0,108,40913,0,0,2021-01-03,AR,10474,538513,80,99115,10554,637628
1870,2021-01-03,AR,572,252236,0,108,40913,0,0,2021-01-03,AR,8883,161385,1026,46080,9909,207465
1871,2021-01-03,AR,572,252236,0,108,40913,0,0,2021-01-03,AR,1459,42143,2356,21554,3815,63697
1872,2021-01-03,AR,572,252236,0,108,40913,0,0,2021-01-03,AR,52,6477,0,0,52,6477
1873,2021-01-03,AR,497,264735,0,106,43309,0,0,2021-01-03,AR,9468,5301432,18076,4358185,27544,9659617
1874,2021-01-03,AR,497,264735,0,106,43309,0,0,2021-01-03,AR,20785,5012390,22576,3808023,43361,8820413
1875,2021-01-03,AR,497,264735,0,106,43309,0,0,2021-01-03,AR,2941,4278045,12967,3328046,15908,7606091
1876,2021-01-03,AR,497,264735,0,106,43309,0,0,2021-01-03,AR,9145,4081968,52498,2348462,61643,6430430
1877,2021-01-03,AR,497,264735,0,106,43309,0,0,2021-01-03,AR,29869,3711593,28367,1111866,58236,4823459
1878,2021-01-03,AR,497,264735,0,106,43309,0,0,2021-01-03,AR,35220,2616956,11966,646445,47186,3263401
1879,2021-01-03,AR,497,264735,0,106,43309,0,0,2021-01-03,AR,44893,1534631,4931,436685,49824,1971316
1880,2021-01-03,AR,497,264735,0,106,43309,0,0,2021-01-03,AR,13128,1056262,10562,153871,23690,1210133
1881,2021-01-03,AR,497,264735,0,106,43309,0,0,2021-01-03,AR,10474,538513,80,99115,10554,637628
1882,2021-01-03,AR,497,264735,0,106,43309,0,0,2021-01-03,AR,8883,161385,1026,46080,9909,207465
1883,2021-01-03,AR,497,264735,0,106,43309,0,0,2021-01-03,AR,1459,42143,2356,21554,3815,63697
1884,2021-01-03,AR,497,264735,0,106,43309,0,0,2021-01-03,AR,52,6477,0,0,52,6477
1885,2021-01-03,AR,526,280012,0,123,46411,0,0,2021-01-03,AR,9468,5301432,18076,4358185,27544,9659617
1886,2021-01-03,AR,526,280012,0,123,46411,0,0,2021-01-03,AR,20785,5012390,22576,3808023,43361,8820413
1887,2021-01-03,AR,526,280012,0,123,46411,0,0,2021-01-03,AR,2941,4278045,12967,3328046,15908,7606091
1888,2021-01-03,AR,526,280012,0,123,46411,0,0,2021-01-03,AR,9145,4081968,52498,2348462,61643,6430430
1889,2021-01-03,AR,526,280012,0,123,46411,0,0,2021-01-03,AR,29869,3711593,28367,1111866,58236,4823459
1890,2021-01-03,AR,526,280012,0,123,46411,0,0,2021-01-03,AR,35220,2616956,11966,646445,47186,3263401
1891,2021-01-03,AR,526,280012,0,123,46411,0,0,2021-01-03,AR,44893,1534631,4931,436685,49824,1971316
1892,2021-01-03,AR,526,280012,0,123,46411,0,0,2021-01-03,AR,13128,1056262,10562,153871,23690,1210133
1893,2021-01-03,AR,526,280012,0,123,46411,0,0,2021-01-03,AR,10474,538513,80,99115,10554,637628
1894,2021-01-03,AR,526,280012,0,123,46411,0,0,2021-01-03,AR,8883,161385,1026,46080,9909,207465
1895,2021-01-03,AR,526,280012,0,123,46411,0,0,2021-01-03,AR,1459,42143,2356,21554,3815,63697
1896,2021-01-03,AR,526,280012,0,123,46411,0,0,2021-01-03,AR,52,6477,0,0,52,6477
1897,2021-01-03,AR,1027,306355,0,221,51953,0,0,2021-01-03,AR,9468,5301432,18076,4358185,27544,9659617
1898,2021-01-03,AR,1027,306355,0,221,51953,0,0,2021-01-03,AR,20785,5012390,22576,3808023,43361,8820413
1899,2021-01-03,AR,1027,306355,0,221,51953,0,0,2021-01-03,AR,2941,4278045,12967,3328046,15908,7606091
1900,2021-01-03,AR,1027,306355,0,221,51953,0,0,2021-01-03,AR,9145,4081968,52498,2348462,61643,6430430
1901,2021-01-03,AR,1027,306355,0,221,51953,0,0,2021-01-03,AR,29869,3711593,28367,1111866,58236,4823459
1902,2021-01-03,AR,1027,306355,0,221,51953,0,0,2021-01-03,AR,35220,2616956,11966,646445,47186,3263401
1903,2021-01-03,AR,1027,306355,0,221,51953,0,0,2021-01-03,AR,44893,1534631,4931,436685,49824,1971316
1904,2021-01-03,AR,1027,306355,0,221,51953,0,0,2021-01-03,AR,13128,1056262,10562,153871,23690,1210133
1905,2021-01-03,AR,1027,306355,0,221,51953,0,0,2021-01-03,AR,10474,538513,80,99115,10554,637628
1906,2021-01-03,AR,1027,306355,0,221,51953,0,0,2021-01-03,AR,8883,161385,1026,46080,9909,207465
1907,2021-01-03,AR,1027,306355,0,221,51953,0,0,2021-01-03,AR,1459,42143,2356,21554,3815,63697
1908,2021-01-03,AR,1027,306355,0,221,51953,0,0,2021-01-03,AR,52,6477,0,0,52,6477
1909,2021-01-03,AR,1257,339949,0,250,59388,0,0,2021-01-03,AR,9468,5301432,18076,4358185,27544,9659617
1910,2021-01-03,AR,1257,339949,0,250,59388,0,0,2021-01-03,AR,20785,5012390,22576,3808023,43361,8820413
1911,2021-01-03,AR,1257,339949,0,250,59388,0,0,2021-01-03,AR,2941,4278045,12967,3328046,15908,7606091
1912,2021-01-03,AR,1257,339949,0,250,59388,0,0,2021-01-03,AR,9145,4081968,52498,2348462,61643,6430430
1913,2021-01-03,AR,1257,339949,0,250,59388,0,0,2021-01-03,AR,29869,3711593,28367,1111866,58236,4823459
1914,2021-01-03,AR,1257,339949,0,250,59388,0,0,2021-01-03,AR,35220,2616956,11966,646445,47186,3263401
1915,2021-01-03,AR,1257,339949,0,250,59388,0,0,2021-01-03,AR,44893,1534631,4931,436685,49824,1971316
1916,2021-01-03,AR,1257,339949,0,250,59388,0,0,2021-01-03,AR,13128,1056262,10562,153871,23690,1210133
1917,2021-01-03,AR,1257,339949,0,250,59388,0,0,2021-01-03,AR,10474,538513,80,99115,10554,637628
1918,2021-01-03,AR,1257,339949,0,250,59388,0,0,2021-01-03,AR,8883,161385,1026,46080,9909,207465
1919,2021-01-03,AR,1257,339949,0,250,59388,0,0,2021-01-03,AR,1459,42143,2356,21554,3815,63697
1920,2021-01-03,AR,1257,339949,0,250,59388,0,0,2021-01-03,AR,52,6477,0,0,52,6477
1921,2021-01-03,AR,679,368008,0,141,65524,0,0,2021-01-03,AR,9468,5301432,18076,4358185,27544,9659617
1922,2021-01-03,AR,679,368008,0,141,65524,0,0,2021-01-03,AR,20785,5012390,22576,3808023,43361,8820413
1923,2021-01-03,AR,679,368008,0,141,65524,0,0,2021-01-03,AR,2941,4278045,12967,3328046,15908,7606091
1924,2021-01-03,AR,679,368008,0,141,65524,0,0,2021-01-03,AR,9145,4081968,52498,2348462,61643,6430430
1925,2021-01-03,AR,679,368008,0,141,65524,0,0,2021-01-03,AR,29869,3711593,28367,1111866,58236,4823459
1926,2021-01-03,AR,679,368008,0,141,65524,0,0,2021-01-03,AR,35220,2616956,11966,646445,47186,3263401
1927,2021-01-03,AR,679,368008,0,141,65524,0,0,2021-01-03,AR,44893,1534631,4931,436685,49824,1971316
1928,2021-01-03,AR,679,368008,0,141,65524,0,0,2021-01-03,AR,13128,1056262,10562,153871,23690,1210133
1929,2021-01-03,AR,679,368008,0,141,65524,0,0,2021-01-03,AR,10474,538513,80,99115,10554,637628
1930,2021-01-03,AR,679,368008,0,141,65524,0,0,2021-01-03,AR,8883,161385,1026,46080,9909,207465
1931,2021-01-03,AR,679,368008,0,141,65524,0,0,2021-01-03,AR,1459,42143,2356,21554,3815,63697
1932,2021-01-03,AR,679,368008,0,141,65524,0,0,2021-01-03,AR,52,6477,0,0,52,6477
1933,2021-01-03,AR,719,390283,0,126,69817,0,0,2021-01-03,AR,9468,5301432,18076,4358185,27544,9659617
1934,2021-01-03,AR,719,390283,0,126,69817,0,0,2021-01-03,AR,20785,5012390,22576,3808023,43361,8820413
1935,2021-01-03,AR,719,390283,0,126,69817,0,0,2021-01-03,AR,2941,4278045,12967,3328046,15908,7606091
1936,2021-01-03,AR,719,390283,0,126,69817,0,0,2021-01-03,AR,9145,4081968,52498,2348462,61643,6430430
1937,2021-01-03,AR,719,390283,0,126,69817,0,0,2021-01-03,AR,29869,3711593,28367,1111866,58236,4823459
1938,2021-01-03,AR,719,390283,0,126,69817,0,0,2021-01-03,AR,35220,2616956,11966,646445,47186,3263401
1939,2021-01-03,AR,719,390283,0,126,69817,0,0,2021-01-03,AR,44893,1534631,4931,436685,49824,1971316
1940,2021-01-03,AR,719,390283,0,126,69817,0,0,2021-01-03,AR,13128,1056262,10562,153871,23690,1210133
1941,2021-01-03,AR,719,390283,0,126,69817,0,0,2021-01-03,AR,10474,538513,80,99115,10554,637628
1942,2021-01-03,AR,719,390283,0,126,69817,0,0,2021-01-03,AR,8883,161385,1026,46080,9909,207465
1943,2021-01-03,AR,719,390283,0,126,69817,0,0,2021-01-03,AR,1459,42143,2356,21554,3815,63697
1944,2021-01-03,AR,719,390283,0,126,69817,0,0,2021-01-03,AR,52,6477,0,0,52,6477
1945,2021-01-03,AR,373,406106,0,57,72504,0,0,2021-01-03,AR,9468,5301432,18076,4358185,27544,9659617
1946,2021-01-03,AR,373,406106,0,57,72504,0,0,2021-01-03,AR,20785,5012390,22576,3808023,43361,8820413
1947,2021-01-03,AR,373,406106,0,57,72504,0,0,2021-01-03,AR,2941,4278045,12967,3328046,15908,7606091
1948,2021-01-03,AR,373,406106,0,57,72504,0,0,2021-01-03,AR,9145,4081968,52498,2348462,61643,6430430
1949,2021-01-03,AR,373,406106,0,57,72504,0,0,2021-01-03,AR,29869,3711593,28367,1111866,58236,4823459
1950,2021-01-03,AR,373,406106,0,57,72504,0,0,2021-01-03,AR,35220,2616956,11966,646445,47186,3263401
1951,2021-01-03,AR,373,406106,0,57,72504,0,0,2021-01-03,AR,44893,1534631,4931,436685,49824,1971316
1952,2021-01-03,AR,373,406106,0,57,72504,0,0,2021-01-03,AR,13128,1056262,10562,153871,23690,1210133
1953,2021-01-03,AR,373,406106,0,57,72504,0,0,2021-01-03,AR,10474,538513,80,99115,10554,637628
1954,2021-01-03,AR,373,406106,0,57,72504,0,0,2021-01-03,AR,8883,161385,1026,46080,9909,207465
1955,2021-01-03,AR,373,406106,0,57,72504,0,0,2021-01-03,AR,1459,42143,2356,21554,3815,63697
1956,2021-01-03,AR,373,406106,0,57,72504,0,0,2021-01-03,AR,52,6477,0,0,52,6477
1957,2021-01-03,AR,262,415518,0,26,73731,0,0,2021-01-03,AR,9468,5301432,18076,4358185,27544,9659617
1958,2021-01-03,AR,262,415518,0,26,73731,0,0,2021-01-03,AR,20785,5012390,22576,3808023,43361,8820413
1959,2021-01-03,AR,262,415518,0,26,73731,0,0,2021-01-03,AR,2941,4278045,12967,3328046,15908,7606091
1960,2021-01-03,AR,262,415518,0,26,73731,0,0,2021-01-03,AR,9145,4081968,52498,2348462,61643,6430430
1961,2021-01-03,AR,262,415518,0,26,73731,0,0,2021-01-03,AR,29869,3711593,28367,1111866,58236,4823459
1962,2021-01-03,AR,262,415518,0,26,73731,0,0,2021-01-03,AR,35220,2616956,11966,646445,47186,3263401
1963,2021-01-03,AR,262,415518,0,26,73731,0,0,2021-01-03,AR,44893,1534631,4931,436685,49824,1971316
1964,2021-01-03,AR,262,415518,0,26,73731,0,0,2021-01-03,AR,13128,1056262,10562,153871,23690,1210133
1965,2021-01-03,AR,262,415518,0,26,73731,0,0,2021-01-03,AR,10474,538513,80,99115,10554,637628
1966,2021-01-03,AR,262,415518,0,26,73731,0,0,2021-01-03,AR,8883,161385,1026,46080,9909,207465
1967,2021-01-03,AR,262,415518,0,26,73731,0,0,2021-01-03,AR,1459,42143,2356,21554,3815,63697
1968,2021-01-03,AR,262,415518,0,26,73731,0,0,2021-01-03,AR,52,6477,0,0,52,6477
1969,2021-01-03,AR,296,423447,0,43,74660,0,0,2021-01-03,AR,9468,5301432,18076,4358185,27544,9659617
1970,2021-01-03,AR,296,423447,0,43,74660,0,0,2021-01-03,AR,20785,5012390,22576,3808023,43361,8820413
1971,2021-01-03,AR,296,423447,0,43,74660,0,0,2021-01-03,AR,2941,4278045,12967,3328046,15908,7606091
1972,2021-01-03,AR,296,423447,0,43,74660,0,0,2021-01-03,AR,9145,4081968,52498,2348462,61643,6430430
1973,2021-01-03,AR,296,423447,0,43,74660,0,0,2021-01-03,AR,29869,3711593,28367,1111866,58236,4823459
1974,2021-01-03,AR,296,423447,0,43,74660,0,0,2021-01-03,AR,35220,2616956,11966,646445,47186,3263401
1975,2021-01-03,AR,296,423447,0,43,74660,0,0,2021-01-03,AR,44893,1534631,4931,436685,49824,1971316
1976,2021-01-03,AR,296,423447,0,43,74660,0,0,2021-01-03,AR,13128,1056262,10562,153871,23690,1210133
1977,2021-01-03,AR,296,423447,0,43,74660,0,0,2021-01-03,AR,10474,538513,80,99115,10554,637628
1978,2021-01-03,AR,296,423447,0,43,74660,0,0,2021-01-03,AR,8883,161385,1026,46080,9909,207465
1979,2021-01-03,AR,296,423447,0,43,74660,0,0,2021-01-03,AR,1459,42143,2356,21554,3815,63697
1980,2021-01-03,AR,296,423447,0,43,74660,0,0,2021-01-03,AR,52,6477,0,0,52,6477
1981,2021-01-03,AR,190,430059,0,18,75518,0,0,2021-01-03,AR,9468,5301432,18076,4358185,27544,9659617
1982,2021-01-03,AR,190,430059,0,18,75518,0,0,2021-01-03,AR,20785,5012390,22576,3808023,43361,8820413
1983,2021-01-03,AR,190,430059,0,18,75518,0,0,2021-01-03,AR,2941,4278045,12967,3328046,15908,7606091
1984,2021-01-03,AR,190,430059,0,18,75518,0,0,2021-01-03,AR,9145,4081968,52498,2348462,61643,6430430
1985,2021-01-03,AR,190,430059,0,18,75518,0,0,2021-01-03,AR,29869,3711593,28367,1111866,58236,4823459
1986,2021-01-03,AR,190,430059,0,18,75518,0,0,2021-01-03,AR,35220,2616956,11966,646445,47186,3263401
1987,2021-01-03,AR,190,430059,0,18,75518,0,0,2021-01-03,AR,44893,1534631,4931,436685,49824,1971316
1988,2021-01-03,AR,190,430059,0,18,75518,0,0,2021-01-03,AR,13128,1056262,10562,153871,23690,1210133
1989,2021-01-03,AR,190,430059,0,18,75518,0,0,2021-01-03,AR,10474,538513,80,99115,10554,637628
1990,2021-01-03,AR,190,430059,0,18,75518,0,0,2021-01-03,AR,8883,161385,1026,46080,9909,207465
1991,2021-01-03,AR,190,430059,0,18,75518,0,0,2021-01-03,AR,1459,42143,2356,21554,3815,63697
1992,2021-01-03,AR,190,430059,0,18,75518,0,0,2021-01-03,AR,52,6477,0,0,52,6477
1993,2021-01-21,AR,672,245676,0,144,39566,0,0,2021-01-21,AR,7734,5404956,16105,4593266,23839,9998222
1994,2021-01-21,AR,672,245676,0,144,39566,0,0,2021-01-21,AR,2684,5204612,6937,4129925,9621,9334537
1995,2021-01-21,AR,672,245676,0,144,39566,0,0,2021-01-21,AR,39442,4665470,18505,3634073,57947,8299543
1996,2021-01-21,AR,672,245676,0,144,39566,0,0,2021-01-21,AR,6794,4182385,38043,3012726,44837,7195111
1997,2021-01-21,AR,672,245676,0,144,39566,0,0,2021-01-21,AR,8034,3947985,29308,1774872,37342,5722857
1998,2021-01-21,AR,672,245676,0,144,39566,0,0,2021-01-21,AR,45977,3329998,13956,840047,59933,4170045
1999,2021-01-21,AR,672,245676,0,144,39566,0,0,2021-01-21,AR,21878,2141119,3598,547100,25476,2688219
2000,2021-01-21,AR,672,245676,0,144,39566,0,0,2021-01-21,AR,13617,1275119,12091,344624,25708,1619743
2001,2021-01-21,AR,672,245676,0,144,39566,0,0,2021-01-21,AR,22861,875088,1914,123761,24775,998849
2002,2021-01-21,AR,672,245676,0,144,39566,0,0,2021-01-21,AR,2469,372484,160,88438,2629,460922
2003,2021-01-21,AR,672,245676,0,144,39566,0,0,2021-01-21,AR,2908,78527,3,38076,2911,116603
2004,2021-01-21,AR,672,245676,0,144,39566,0,0,2021-01-21,AR,687,36006,1271,3960,1958,39966
2005,2021-01-21,AR,366,260058,0,69,42477,0,0,2021-01-21,AR,7734,5404956,16105,4593266,23839,9998222
2006,2021-01-21,AR,366,260058,0,69,42477,0,0,2021-01-21,AR,2684,5204612,6937,4129925,9621,9334537
2007,2021-01-21,AR,366,260058,0,69,42477,0,0,2021-01-21,AR,39442,4665470,18505,3634073,57947,8299543
2008,2021-01-21,AR,366,260058,0,69,42477,0,0,2021-01-21,AR,6794,4182385,38043,3012726,44837,7195111
2009,2021-01-21,AR,366,260058,0,69,42477,0,0,2021-01-21,AR,8034,3947985,29308,1774872,37342,5722857
2010,2021-01-21,AR,366,260058,0,69,42477,0,0,2021-01-21,AR,45977,3329998,13956,840047,59933,4170045
2011,2021-01-21,AR,366,260058,0,69,42477,0,0,2021-01-21,AR,21878,2141119,3598,547100,25476,2688219
2012,2021-01-21,AR,366,260058,0,69,42477,0,0,2021-01-21,AR,13617,1275119,12091,344624,25708,1619743
2013,2021-01-21,AR,366,260058,0,69,42477,0,0,2021-01-21,AR,22861,875088,1914,123761,24775,998849
2014,2021-01-21,AR,366,260058,0,69,42477,0,0,2021-01-21,AR,2469,372484,160,88438,2629,460922
2015,2021-01-21,AR,366,260058,0,69,42477,0,0,2021-01-21,AR,2908,78527,3,38076,2911,116603
2016,2021-01-21,AR,366,260058,0,69,42477,0,0,2021-01-21,AR,687,36006,1271,3960,1958,39966
2017,2021-01-21,AR,373,272911,0,83,44928,0,0,2021-01-21,AR,7734,5404956,16105,4593266,23839,9998222
2018,2021-01-21,AR,373,272911,0,83,44928,0,0,2021-01-21,AR,2684,5204612,6937,4129925,9621,9334537
2019,2021-01-21,AR,373,272911,0,83,44928,0,0,2021-01-21,AR,39442,4665470,18505,3634073,57947,8299543
2020,2021-01-21,AR,373,272911,0,83,44928,0,0,2021-01-21,AR,6794,4182385,38043,3012726,44837,7195111
2021,2021-01-21,AR,373,272911,0,83,44928,0,0,2021-01-21,AR,8034,3947985,29308,1774872,37342,5722857
2022,2021-01-21,AR,373,272911,0,83,44928,0,0,2021-01-21,AR,45977,3329998,13956,840047,59933,4170045
2023,2021-01-21,AR,373,272911,0,83,44928,0,0,2021-01-21,AR,21878,2141119,3598,547100,25476,2688219
2024,2021-01-21,AR,373,272911,0,83,44928,0,0,2021-01-21,AR,13617,1275119,12091,344624,25708,1619743
2025,2021-01-21,AR,373,272911,0,83,44928,0,0,2021-01-21,AR,22861,875088,1914,123761,24775,998849
2026,2021-01-21,AR,373,272911,0,83,44928,0,0,2021-01-21,AR,2469,372484,160,88438,2629,460922
2027,2021-01-21,AR,373,272911,0,83,44928,0,0,2021-01-21,AR,2908,78527,3,38076,2911,116603
2028,2021-01-21,AR,373,272911,0,83,44928,0,0,2021-01-21,AR,687,36006,1271,3960,1958,39966
2029,2021-01-21,AR,999,295514,0,196,49562,0,0,2021-01-21,AR,7734,5404956,16105,4593266,23839,9998222
2030,2021-01-21,AR,999,295514,0,196,49562,0,0,2021-01-21,AR,2684,5204612,6937,4129925,9621,9334537
2031,2021-01-21,AR,999,295514,0,196,49562,0,0,2021-01-21,AR,39442,4665470,18505,3634073,57947,8299543
2032,2021-01-21,AR,999,295514,0,196,49562,0,0,2021-01-21,AR,6794,4182385,38043,3012726,44837,7195111
2033,2021-01-21,AR,999,295514,0,196,49562,0,0,2021-01-21,AR,8034,3947985,29308,1774872,37342,5722857
2034,2021-01-21,AR,999,295514,0,196,49562,0,0,2021-01-21,AR,45977,3329998,13956,840047,59933,4170045
2035,2021-01-21,AR,999,295514,0,196,49562,0,0,2021-01-21,AR,21878,2141119,3598,547100,25476,2688219
2036,2021-01-21,AR,999,295514,0,196,49562,0,0,2021-01-21,AR,13617,1275119,12091,344624,25708,1619743
2037,2021-01-21,AR,999,295514,0,196,49562,0,0,2021-01-21,AR,22861,875088,1914,123761,24775,998849
2038,2021-01-21,AR,999,295514,0,196,49562,0,0,2021-01-21,AR,2469,372484,160,88438,2629,460922
2039,2021-01-21,AR,999,295514,0,196,49562,0,0,2021-01-21,AR,2908,78527,3,38076,2911,116603
2040,2021-01-21,AR,999,295514,0,196,49562,0,0,2021-01-21,AR,687,36006,1271,3960,1958,39966
2041,2021-01-21,AR,1116,324537,0,261,55985,0,0,2021-01-21,AR,7734,5404956,16105,4593266,23839,9998222
2042,2021-01-21,AR,1116,324537,0,261,55985,0,0,2021-01-21,AR,2684,5204612,6937,4129925,9621,9334537
2043,2021-01-21,AR,1116,324537,0,261,55985,0,0,2021-01-21,AR,39442,4665470,18505,3634073,57947,8299543
2044,2021-01-21,AR,1116,324537,0,261,55985,0,0,2021-01-21,AR,6794,4182385,38043,3012726,44837,7195111
2045,2021-01-21,AR,1116,324537,0,261,55985,0,0,2021-01-21,AR,8034,3947985,29308,1774872,37342,5722857
2046,2021-01-21,AR,1116,324537,0,261,55985,0,0,2021-01-21,AR,45977,3329998,13956,840047,59933,4170045
2047,2021-01-21,AR,1116,324537,0,261,55985,0,0,2021-01-21,AR,21878,2141119,3598,547100,25476,2688219
2048,2021-01-21,AR,1116,324537,0,261,55985,0,0,2021-01-21,AR,13617,1275119,12091,344624,25708,1619743
2049,2021-01-21,AR,1116,324537,0,261,55985,0,0,2021-01-21,AR,22861,875088,1914,123761,24775,998849
2050,2021-01-21,AR,1116,324537,0,261,55985,0,0,2021-01-21,AR,2469,372484,160,88438,2629,460922
2051,2021-01-21,AR,1116,324537,0,261,55985,0,0,2021-01-21,AR,2908,78527,3,38076,2911,116603
2052,2021-01-21,AR,1116,324537,0,261,55985,0,0,2021-01-21,AR,687,36006,1271,3960,1958,39966
2053,2021-01-21,AR,833,357753,0,169,63393,0,0,2021-01-21,AR,7734,5404956,16105,4593266,23839,9998222
2054,2021-01-21,AR,833,357753,0,169,63393,0,0,2021-01-21,AR,2684,5204612,6937,4129925,9621,9334537
2055,2021-01-21,AR,833,357753,0,169,63393,0,0,2021-01-21,AR,39442,4665470,18505,3634073,57947,8299543
2056,2021-01-21,AR,833,357753,0,169,63393,0,0,2021-01-21,AR,6794,4182385,38043,3012726,44837,7195111
2057,2021-01-21,AR,833,357753,0,169,63393,0,0,2021-01-21,AR,8034,3947985,29308,1774872,37342,5722857
2058,2021-01-21,AR,833,357753,0,169,63393,0,0,2021-01-21,AR,45977,3329998,13956,840047,59933,4170045
2059,2021-01-21,AR,833,357753,0,169,63393,0,0,2021-01-21,AR,21878,2141119,3598,547100,25476,2688219
2060,2021-01-21,AR,833,357753,0,169,63393,0,0,2021-01-21,AR,13617,1275119,12091,344624,25708,1619743
2061,2021-01-21,AR,833,357753,0,169,63393,0,0,2021-01-21,AR,22861,875088,1914,123761,24775,998849
2062,2021-01-21,AR,833,357753,0,169,63393,0,0,2021-01-21,AR,2469,372484,160,88438,2629,460922
2063,2021-01-21,AR,833,357753,0,169,63393,0,0,2021-01-21,AR,2908,78527,3,38076,2911,116603
2064,2021-01-21,AR,833,357753,0,169,63393,0,0,2021-01-21,AR,687,36006,1271,3960,1958,39966
2065,2021-01-21,AR,748,381919,0,113,68258,0,0,2021-01-21,AR,7734,5404956,16105,4593266,23839,9998222
2066,2021-01-21,AR,748,381919,0,113,68258,0,0,2021-01-21,AR,2684,5204612,6937,4129925,9621,9334537
2067,2021-01-21,AR,748,381919,0,113,68258,0,0,2021-01-21,AR,39442,4665470,18505,3634073,57947,8299543
2068,2021-01-21,AR,748,381919,0,113,68258,0,0,2021-01-21,AR,6794,4182385,38043,3012726,44837,7195111
2069,2021-01-21,AR,748,381919,0,113,68258,0,0,2021-01-21,AR,8034,3947985,29308,1774872,37342,5722857
2070,2021-01-21,AR,748,381919,0,113,68258,0,0,2021-01-21,AR,45977,3329998,13956,840047,59933,4170045
2071,2021-01-21,AR,748,381919,0,113,68258,0,0,2021-01-21,AR,21878,2141119,3598,547100,25476,2688219
2072,2021-01-21,AR,748,381919,0,113,68258,0,0,2021-01-21,AR,13617,1275119,12091,344624,25708,1619743
2073,2021-01-21,AR,748,381919,0,113,68258,0,0,2021-01-21,AR,22861,875088,1914,123761,24775,998849
2074,2021-01-21,AR,748,381919,0,113,68258,0,0,2021-01-21,AR,2469,372484,160,88438,2629,460922
2075,2021-01-21,AR,748,381919,0,113,68258,0,0,2021-01-21,AR,2908,78527,3,38076,2911,116603
2076,2021-01-21,AR,748,381919,0,113,68258,0,0,2021-01-21,AR,687,36006,1271,3960,1958,39966
2077,2021-01-21,AR,404,400137,0,63,71600,0,0,2021-01-21,AR,7734,5404956,16105,4593266,23839,9998222
2078,2021-01-21,AR,404,400137,0,63,71600,0,0,2021-01-21,AR,2684,5204612,6937,4129925,9621,9334537
2079,2021-01-21,AR,404,400137,0,63,71600,0,0,2021-01-21,AR,39442,4665470,18505,3634073,57947,8299543
2080,2021-01-21,AR,404,400137,0,63,71600,0,0,2021-01-21,AR,6794,4182385,38043,3012726,44837,7195111
2081,2021-01-21,AR,404,400137,0,63,71600,0,0,2021-01-21,AR,8034,3947985,29308,1774872,37342,5722857
2082,2021-01-21,AR,404,400137,0,63,71600,0,0,2021-01-21,AR,45977,3329998,13956,840047,59933,4170045
2083,2021-01-21,AR,404,400137,0,63,71600,0,0,2021-01-21,AR,21878,2141119,3598,547100,25476,2688219
2084,2021-01-21,AR,404,400137,0,63,71600,0,0,2021-01-21,AR,13617,1275119,12091,344624,25708,1619743
2085,2021-01-21,AR,404,400137,0,63,71600,0,0,2021-01-21,AR,22861,875088,1914,123761,24775,998849
2086,2021-01-21,AR,404,400137,0,63,71600,0,0,2021-01-21,AR,2469,372484,160,88438,2629,460922
2087,2021-01-21,AR,404,400137,0,63,71600,0,0,2021-01-21,AR,2908,78527,3,38076,2911,116603
2088,2021-01-21,AR,404,400137,0,63,71600,0,0,2021-01-21,AR,687,36006,1271,3960,1958,39966
2089,2021-01-21,AR,349,412352,0,42,73343,0,0,2021-01-21,AR,7734,5404956,16105,4593266,23839,9998222
2090,2021-01-21,AR,349,412352,0,42,73343,0,0,2021-01-21,AR,2684,5204612,6937,4129925,9621,9334537
2091,2021-01-21,AR,349,412352,0,42,73343,0,0,2021-01-21,AR,39442,4665470,18505,3634073,57947,8299543
2092,2021-01-21,AR,349,412352,0,42,73343,0,0,2021-01-21,AR,6794,4182385,38043,3012726,44837,7195111
2093,2021-01-21,AR,349,412352,0,42,73343,0,0,2021-01-21,AR,8034,3947985,29308,1774872,37342,5722857
2094,2021-01-21,AR,349,412352,0,42,73343,0,0,2021-01-21,AR,45977,3329998,13956,840047,59933,4170045
2095,2021-01-21,AR,349,412352,0,42,73343,0,0,2021-01-21,AR,21878,2141119,3598,547100,25476,2688219
2096,2021-01-21,AR,349,412352,0,42,73343,0,0,2021-01-21,AR,13617,1275119,12091,344624,25708,1619743
2097,2021-01-21,AR,349,412352,0,42,73343,0,0,2021-01-21,AR,22861,875088,1914,123761,24775,998849
2098,2021-01-21,AR,349,412352,0,42,73343,0,0,2021-01-21,AR,2469,372484,160,88438,2629,460922
2099,2021-01-21,AR,349,412352,0,42,73343,0,0,2021-01-21,AR,2908,78527,3,38076,2911,116603
2100,2021-01-21,AR,349,412352,0,42,73343,0,0,2021-01-21,AR,687,36006,1271,3960,1958,39966
2101,2021-01-21,AR,254,420191,0,33,74279,0,0,2021-01-21,AR,7734,5404956,16105,4593266,23839,9998222
2102,2021-01-21,AR,254,420191,0,33,74279,0,0,2021-01-21,AR,2684,5204612,6937,4129925,9621,9334537
2103,2021-01-21,AR,254,420191,0,33,74279,0,0,2021-01-21,AR,39442,4665470,18505,3634073,57947,8299543
2104,2021-01-21,AR,254,420191,0,33,74279,0,0,2021-01-21,AR,6794,4182385,38043,3012726,44837,7195111
2105,2021-01-21,AR,254,420191,0,33,74279,0,0,2021-01-21,AR,8034,3947985,29308,1774872,37342,5722857
2106,2021-01-21,AR,254,420191,0,33,74279,0,0,2021-01-21,AR,45977,3329998,13956,840047,59933,4170045
2107,2021-01-21,AR,254,420191,0,33,74279,0,0,2021-01-21,AR,21878,2141119,3598,547100,25476,2688219
2108,2021-01-21,AR,254,420191,0,33,74279,0,0,2021-01-21,AR,13617,1275119,12091,344624,25708,1619743
2109,2021-01-21,AR,254,420191,0,33,74279,0,0,2021-01-21,AR,22861,875088,1914,123761,24775,998849
2110,2021-01-21,AR,254,420191,0,33,74279,0,0,2021-01-21,AR,2469,372484,160,88438,2629,460922
2111,2021-01-21,AR,254,420191,0,33,74279,0,0,2021-01-21,AR,2908,78527,3,38076,2911,116603
2112,2021-01-21,AR,254,420191,0,33,74279,0,0,2021-01-21,AR,687,36006,1271,3960,1958,39966
2113,2021-01-21,AR,151,427305,0,25,75143,0,0,2021-01-21,AR,7734,5404956,16105,4593266,23839,9998222
2114,2021-01-21,AR,151,427305,0,25,75143,0,0,2021-01-21,AR,2684,5204612,6937,4129925,9621,9334537
2115,2021-01-21,AR,151,427305,0,25,75143,0,0,2021-01-21,AR,39442,4665470,18505,3634073,57947,8299543
2116,2021-01-21,AR,151,427305,0,25,75143,0,0,2021-01-21,AR,6794,4182385,38043,3012726,44837,7195111
2117,2021-01-21,AR,151,427305,0,25,75143,0,0,2021-01-21,AR,8034,3947985,29308,1774872,37342,5722857
2118,2021-01-21,AR,151,427305,0,25,75143,0,0,2021-01-21,AR,45977,3329998,13956,840047,59933,4170045
2119,2021-01-21,AR,151,427305,0,25,75143,0,0,2021-01-21,AR,21878,2141119,3598,547100,25476,2688219
2120,2021-01-21,AR,151,427305,0,25,75143,0,0,2021-01-21,AR,13617,1275119,12091,344624,25708,1619743
2121,2021-01-21,AR,151,427305,0,25,75143,0,0,2021-01-21,AR,22861,875088,1914,123761,24775,998849
2122,2021-01-21,AR,151,427305,0,25,75143,0,0,2021-01-21,AR,2469,372484,160,88438,2629,460922
2123,2021-01-21,AR,151,427305,0,25,75143,0,0,2021-01-21,AR,2908,78527,3,38076,2911,116603
2124,2021-01-21,AR,151,427305,0,25,75143,0,0,2021-01-21,AR,687,36006,1271,3960,1958,39966
2125,2021-01-21,AR,264,434020,0,38,76120,0,0,2021-01-21,AR,7734,5404956,16105,4593266,23839,9998222
2126,2021-01-21,AR,264,434020,0,38,76120,0,0,2021-01-21,AR,2684,5204612,6937,4129925,9621,9334537
2127,2021-01-21,AR,264,434020,0,38,76120,0,0,2021-01-21,AR,39442,4665470,18505,3634073,57947,8299543
2128,2021-01-21,AR,264,434020,0,38,76120,0,0,2021-01-21,AR,6794,4182385,38043,3012726,44837,7195111
2129,2021-01-21,AR,264,434020,0,38,76120,0,0,2021-01-21,AR,8034,3947985,29308,1774872,37342,5722857
2130,2021-01-21,AR,264,434020,0,38,76120,0,0,2021-01-21,AR,45977,3329998,13956,840047,59933,4170045
2131,2021-01-21,AR,264,434020,0,38,76120,0,0,2021-01-21,AR,21878,2141119,3598,547100,25476,2688219
2132,2021-01-21,AR,264,434020,0,38,76120,0,0,2021-01-21,AR,13617,1275119,12091,344624,25708,1619743
2133,2021-01-21,AR,264,434020,0,38,76120,0,0,2021-01-21,AR,22861,875088,1914,123761,24775,998849
2134,2021-01-21,AR,264,434020,0,38,76120,0,0,2021-01-21,AR,2469,372484,160,88438,2629,460922
2135,2021-01-21,AR,264,434020,0,38,76120,0,0,2021-01-21,AR,2908,78527,3,38076,2911,116603
2136,2021-01-21,AR,264,434020,0,38,76120,0,0,2021-01-21,AR,687,36006,1271,3960,1958,39966
2137,2021-01-04,AR,759,235424,0,106,37663,0,0,2021-01-04,AR,4249,5305681,9117,4367302,13366,9672983
2138,2021-01-04,AR,759,235424,0,106,37663,0,0,2021-01-04,AR,25158,5037548,21486,3829509,46644,8867057
2139,2021-01-04,AR,759,235424,0,106,37663,0,0,2021-01-04,AR,8899,4286944,23759,3351805,32658,7638749
2140,2021-01-04,AR,759,235424,0,106,37663,0,0,2021-01-04,AR,5812,4087780,39069,2387531,44881,6475311
2141,2021-01-04,AR,759,235424,0,106,37663,0,0,2021-01-04,AR,24935,3736528,33519,1145385,58454,4881913
2142,2021-01-04,AR,759,235424,0,106,37663,0,0,2021-01-04,AR,23443,2640399,2959,649404,26402,3289803
2143,2021-01-04,AR,759,235424,0,106,37663,0,0,2021-01-04,AR,52432,1587063,5896,442581,58328,2029644
2144,2021-01-04,AR,759,235424,0,106,37663,0,0,2021-01-04,AR,18328,1074590,13295,167166,31623,1241756
2145,2021-01-04,AR,759,235424,0,106,37663,0,0,2021-01-04,AR,6988,545501,13,99128,7001,644629
2146,2021-01-04,AR,759,235424,0,106,37663,0,0,2021-01-04,AR,13754,175139,1912,47992,15666,223131
2147,2021-01-04,AR,759,235424,0,106,37663,0,0,2021-01-04,AR,1402,43545,2573,24127,3975,67672
2148,2021-01-04,AR,759,235424,0,106,37663,0,0,2021-01-04,AR,1465,7942,1,1,1466,7943
2149,2021-01-16,AR,516,242759,0,98,38989,0,0,2021-01-16,AR,7079,5380014,15512,4539001,22591,9919015
2150,2021-01-16,AR,516,242759,0,98,38989,0,0,2021-01-16,AR,8512,5171323,32414,4017676,40926,9188999
2151,2021-01-16,AR,516,242759,0,98,38989,0,0,2021-01-16,AR,18446,4490524,16736,3562264,35182,8052788
2152,2021-01-16,AR,516,242759,0,98,38989,0,0,2021-01-16,AR,5319,4154361,44365,2839403,49684,6993764
2153,2021-01-16,AR,516,242759,0,98,38989,0,0,2021-01-16,AR,6467,3874372,20690,1565278,27157,5439650
2154,2021-01-16,AR,516,242759,0,98,38989,0,0,2021-01-16,AR,50166,3150376,13614,767009,63780,3917385
2155,2021-01-16,AR,516,242759,0,98,38989,0,0,2021-01-16,AR,30311,1988040,10102,523912,40413,2511952
2156,2021-01-16,AR,516,242759,0,98,38989,0,0,2021-01-16,AR,3405,1188691,5587,302126,8992,1490817
2157,2021-01-16,AR,516,242759,0,98,38989,0,0,2021-01-16,AR,16979,816464,1218,116960,18197,933424
2158,2021-01-16,AR,516,242759,0,98,38989,0,0,2021-01-16,AR,15374,321710,3032,72979,18406,394689
2159,2021-01-16,AR,516,242759,0,98,38989,0,0,2021-01-16,AR,106,53386,30,34608,136,87994
2160,2021-01-16,AR,516,242759,0,98,38989,0,0,2021-01-16,AR,840,31743,0,8,840,31751
2161,2021-01-04,AR,460,252696,0,95,41008,0,0,2021-01-04,AR,4249,5305681,9117,4367302,13366,9672983
2162,2021-01-04,AR,460,252696,0,95,41008,0,0,2021-01-04,AR,25158,5037548,21486,3829509,46644,8867057
2163,2021-01-04,AR,460,252696,0,95,41008,0,0,2021-01-04,AR,8899,4286944,23759,3351805,32658,7638749
2164,2021-01-04,AR,460,252696,0,95,41008,0,0,2021-01-04,AR,5812,4087780,39069,2387531,44881,6475311
2165,2021-01-04,AR,460,252696,0,95,41008,0,0,2021-01-04,AR,24935,3736528,33519,1145385,58454,4881913
2166,2021-01-04,AR,460,252696,0,95,41008,0,0,2021-01-04,AR,23443,2640399,2959,649404,26402,3289803
2167,2021-01-04,AR,460,252696,0,95,41008,0,0,2021-01-04,AR,52432,1587063,5896,442581,58328,2029644
2168,2021-01-04,AR,460,252696,0,95,41008,0,0,2021-01-04,AR,18328,1074590,13295,167166,31623,1241756
2169,2021-01-04,AR,460,252696,0,95,41008,0,0,2021-01-04,AR,6988,545501,13,99128,7001,644629
2170,2021-01-04,AR,460,252696,0,95,41008,0,0,2021-01-04,AR,13754,175139,1912,47992,15666,223131
2171,2021-01-04,AR,460,252696,0,95,41008,0,0,2021-01-04,AR,1402,43545,2573,24127,3975,67672
2172,2021-01-04,AR,460,252696,0,95,41008,0,0,2021-01-04,AR,1465,7942,1,1,1466,7943
2173,2021-01-16,AR,390,258000,0,90,42062,0,0,2021-01-16,AR,7079,5380014,15512,4539001,22591,9919015
2174,2021-01-16,AR,390,258000,0,90,42062,0,0,2021-01-16,AR,8512,5171323,32414,4017676,40926,9188999
2175,2021-01-16,AR,390,258000,0,90,42062,0,0,2021-01-16,AR,18446,4490524,16736,3562264,35182,8052788
2176,2021-01-16,AR,390,258000,0,90,42062,0,0,2021-01-16,AR,5319,4154361,44365,2839403,49684,6993764
2177,2021-01-16,AR,390,258000,0,90,42062,0,0,2021-01-16,AR,6467,3874372,20690,1565278,27157,5439650
2178,2021-01-16,AR,390,258000,0,90,42062,0,0,2021-01-16,AR,50166,3150376,13614,767009,63780,3917385
2179,2021-01-16,AR,390,258000,0,90,42062,0,0,2021-01-16,AR,30311,1988040,10102,523912,40413,2511952
2180,2021-01-16,AR,390,258000,0,90,42062,0,0,2021-01-16,AR,3405,1188691,5587,302126,8992,1490817
2181,2021-01-16,AR,390,258000,0,90,42062,0,0,2021-01-16,AR,16979,816464,1218,116960,18197,933424
2182,2021-01-16,AR,390,258000,0,90,42062,0,0,2021-01-16,AR,15374,321710,3032,72979,18406,394689
2183,2021-01-16,AR,390,258000,0,90,42062,0,0,2021-01-16,AR,106,53386,30,34608,136,87994
2184,2021-01-16,AR,390,258000,0,90,42062,0,0,2021-01-16,AR,840,31743,0,8,840,31751
2185,2021-01-04,AR,505,265240,0,97,43406,0,0,2021-01-04,AR,4249,5305681,9117,4367302,13366,9672983
2186,2021-01-04,AR,505,265240,0,97,43406,0,0,2021-01-04,AR,25158,5037548,21486,3829509,46644,8867057
2187,2021-01-04,AR,505,265240,0,97,43406,0,0,2021-01-04,AR,8899,4286944,23759,3351805,32658,7638749
2188,2021-01-04,AR,505,265240,0,97,43406,0,0,2021-01-04,AR,5812,4087780,39069,2387531,44881,6475311
2189,2021-01-04,AR,505,265240,0,97,43406,0,0,2021-01-04,AR,24935,3736528,33519,1145385,58454,4881913
2190,2021-01-04,AR,505,265240,0,97,43406,0,0,2021-01-04,AR,23443,2640399,2959,649404,26402,3289803
2191,2021-01-04,AR,505,265240,0,97,43406,0,0,2021-01-04,AR,52432,1587063,5896,442581,58328,2029644
2192,2021-01-04,AR,505,265240,0,97,43406,0,0,2021-01-04,AR,18328,1074590,13295,167166,31623,1241756
2193,2021-01-04,AR,505,265240,0,97,43406,0,0,2021-01-04,AR,6988,545501,13,99128,7001,644629
2194,2021-01-04,AR,505,265240,0,97,43406,0,0,2021-01-04,AR,13754,175139,1912,47992,15666,223131
2195,2021-01-04,AR,505,265240,0,97,43406,0,0,2021-01-04,AR,1402,43545,2573,24127,3975,67672
2196,2021-01-04,AR,505,265240,0,97,43406,0,0,2021-01-04,AR,1465,7942,1,1,1466,7943
2197,2021-01-16,AR,522,270646,0,93,44472,0,0,2021-01-16,AR,7079,5380014,15512,4539001,22591,9919015
2198,2021-01-16,AR,522,270646,0,93,44472,0,0,2021-01-16,AR,8512,5171323,32414,4017676,40926,9188999
2199,2021-01-16,AR,522,270646,0,93,44472,0,0,2021-01-16,AR,18446,4490524,16736,3562264,35182,8052788
2200,2021-01-16,AR,522,270646,0,93,44472,0,0,2021-01-16,AR,5319,4154361,44365,2839403,49684,6993764
2201,2021-01-16,AR,522,270646,0,93,44472,0,0,2021-01-16,AR,6467,3874372,20690,1565278,27157,5439650
2202,2021-01-16,AR,522,270646,0,93,44472,0,0,2021-01-16,AR,50166,3150376,13614,767009,63780,3917385
2203,2021-01-16,AR,522,270646,0,93,44472,0,0,2021-01-16,AR,30311,1988040,10102,523912,40413,2511952
2204,2021-01-16,AR,522,270646,0,93,44472,0,0,2021-01-16,AR,3405,1188691,5587,302126,8992,1490817
2205,2021-01-16,AR,522,270646,0,93,44472,0,0,2021-01-16,AR,16979,816464,1218,116960,18197,933424
2206,2021-01-16,AR,522,270646,0,93,44472,0,0,2021-01-16,AR,15374,321710,3032,72979,18406,394689
2207,2021-01-16,AR,522,270646,0,93,44472,0,0,2021-01-16,AR,106,53386,30,34608,136,87994
2208,2021-01-16,AR,522,270646,0,93,44472,0,0,2021-01-16,AR,840,31743,0,8,840,31751
2209,2021-01-04,AR,609,280621,0,123,46534,0,0,2021-01-04,AR,4249,5305681,9117,4367302,13366,9672983
2210,2021-01-04,AR,609,280621,0,123,46534,0,0,2021-01-04,AR,25158,5037548,21486,3829509,46644,8867057
2211,2021-01-04,AR,609,280621,0,123,46534,0,0,2021-01-04,AR,8899,4286944,23759,3351805,32658,7638749
2212,2021-01-04,AR,609,280621,0,123,46534,0,0,2021-01-04,AR,5812,4087780,39069,2387531,44881,6475311
2213,2021-01-04,AR,609,280621,0,123,46534,0,0,2021-01-04,AR,24935,3736528,33519,1145385,58454,4881913
2214,2021-01-04,AR,609,280621,0,123,46534,0,0,2021-01-04,AR,23443,2640399,2959,649404,26402,3289803
2215,2021-01-04,AR,609,280621,0,123,46534,0,0,2021-01-04,AR,52432,1587063,5896,442581,58328,2029644
2216,2021-01-04,AR,609,280621,0,123,46534,0,0,2021-01-04,AR,18328,1074590,13295,167166,31623,1241756
2217,2021-01-04,AR,609,280621,0,123,46534,0,0,2021-01-04,AR,6988,545501,13,99128,7001,644629
2218,2021-01-04,AR,609,280621,0,123,46534,0,0,2021-01-04,AR,13754,175139,1912,47992,15666,223131
2219,2021-01-04,AR,609,280621,0,123,46534,0,0,2021-01-04,AR,1402,43545,2573,24127,3975,67672
2220,2021-01-04,AR,609,280621,0,123,46534,0,0,2021-01-04,AR,1465,7942,1,1,1466,7943
2221,2021-01-16,AR,1026,290863,0,196,48576,0,0,2021-01-16,AR,7079,5380014,15512,4539001,22591,9919015
2222,2021-01-16,AR,1026,290863,0,196,48576,0,0,2021-01-16,AR,8512,5171323,32414,4017676,40926,9188999
2223,2021-01-16,AR,1026,290863,0,196,48576,0,0,2021-01-16,AR,18446,4490524,16736,3562264,35182,8052788
2224,2021-01-16,AR,1026,290863,0,196,48576,0,0,2021-01-16,AR,5319,4154361,44365,2839403,49684,6993764
2225,2021-01-16,AR,1026,290863,0,196,48576,0,0,2021-01-16,AR,6467,3874372,20690,1565278,27157,5439650
2226,2021-01-16,AR,1026,290863,0,196,48576,0,0,2021-01-16,AR,50166,3150376,13614,767009,63780,3917385
2227,2021-01-16,AR,1026,290863,0,196,48576,0,0,2021-01-16,AR,30311,1988040,10102,523912,40413,2511952
2228,2021-01-16,AR,1026,290863,0,196,48576,0,0,2021-01-16,AR,3405,1188691,5587,302126,8992,1490817
2229,2021-01-16,AR,1026,290863,0,196,48576,0,0,2021-01-16,AR,16979,816464,1218,116960,18197,933424
2230,2021-01-16,AR,1026,290863,0,196,48576,0,0,2021-01-16,AR,15374,321710,3032,72979,18406,394689
2231,2021-01-16,AR,1026,290863,0,196,48576,0,0,2021-01-16,AR,106,53386,30,34608,136,87994
2232,2021-01-16,AR,1026,290863,0,196,48576,0,0,2021-01-16,AR,840,31743,0,8,840,31751
2233,2021-01-04,AR,846,307201,0,175,52128,0,0,2021-01-04,AR,4249,5305681,9117,4367302,13366,9672983
2234,2021-01-04,AR,846,307201,0,175,52128,0,0,2021-01-04,AR,25158,5037548,21486,3829509,46644,8867057
2235,2021-01-04,AR,846,307201,0,175,52128,0,0,2021-01-04,AR,8899,4286944,23759,3351805,32658,7638749
2236,2021-01-04,AR,846,307201,0,175,52128,0,0,2021-01-04,AR,5812,4087780,39069,2387531,44881,6475311
2237,2021-01-04,AR,846,307201,0,175,52128,0,0,2021-01-04,AR,24935,3736528,33519,1145385,58454,4881913
2238,2021-01-04,AR,846,307201,0,175,52128,0,0,2021-01-04,AR,23443,2640399,2959,649404,26402,3289803
2239,2021-01-04,AR,846,307201,0,175,52128,0,0,2021-01-04,AR,52432,1587063,5896,442581,58328,2029644
2240,2021-01-04,AR,846,307201,0,175,52128,0,0,2021-01-04,AR,18328,1074590,13295,167166,31623,1241756
2241,2021-01-04,AR,846,307201,0,175,52128,0,0,2021-01-04,AR,6988,545501,13,99128,7001,644629
2242,2021-01-04,AR,846,307201,0,175,52128,0,0,2021-01-04,AR,13754,175139,1912,47992,15666,223131
2243,2021-01-04,AR,846,307201,0,175,52128,0,0,2021-01-04,AR,1402,43545,2573,24127,3975,67672
2244,2021-01-04,AR,846,307201,0,175,52128,0,0,2021-01-04,AR,1465,7942,1,1,1466,7943
2245,2021-01-16,AR,903,318624,0,190,54670,0,0,2021-01-16,AR,7079,5380014,15512,4539001,22591,9919015
2246,2021-01-16,AR,903,318624,0,190,54670,0,0,2021-01-16,AR,8512,5171323,32414,4017676,40926,9188999
2247,2021-01-16,AR,903,318624,0,190,54670,0,0,2021-01-16,AR,18446,4490524,16736,3562264,35182,8052788
2248,2021-01-16,AR,903,318624,0,190,54670,0,0,2021-01-16,AR,5319,4154361,44365,2839403,49684,6993764
2249,2021-01-16,AR,903,318624,0,190,54670,0,0,2021-01-16,AR,6467,3874372,20690,1565278,27157,5439650
2250,2021-01-16,AR,903,318624,0,190,54670,0,0,2021-01-16,AR,50166,3150376,13614,767009,63780,3917385
2251,2021-01-16,AR,903,318624,0,190,54670,0,0,2021-01-16,AR,30311,1988040,10102,523912,40413,2511952
2252,2021-01-16,AR,903,318624,0,190,54670,0,0,2021-01-16,AR,3405,1188691,5587,302126,8992,1490817
2253,2021-01-16,AR,903,318624,0,190,54670,0,0,2021-01-16,AR,16979,816464,1218,116960,18197,933424
2254,2021-01-16,AR,903,318624,0,190,54670,0,0,2021-01-16,AR,15374,321710,3032,72979,18406,394689
2255,2021-01-16,AR,903,318624,0,190,54670,0,0,2021-01-16,AR,106,53386,30,34608,136,87994
2256,2021-01-16,AR,903,318624,0,190,54670,0,0,2021-01-16,AR,840,31743,0,8,840,31751
2257,2021-01-04,AR,1231,341180,0,259,59647,0,0,2021-01-04,AR,4249,5305681,9117,4367302,13366,9672983
2258,2021-01-04,AR,1231,341180,0,259,59647,0,0,2021-01-04,AR,25158,5037548,21486,3829509,46644,8867057
2259,2021-01-04,AR,1231,341180,0,259,59647,0,0,2021-01-04,AR,8899,4286944,23759,3351805,32658,7638749
2260,2021-01-04,AR,1231,341180,0,259,59647,0,0,2021-01-04,AR,5812,4087780,39069,2387531,44881,6475311
2261,2021-01-04,AR,1231,341180,0,259,59647,0,0,2021-01-04,AR,24935,3736528,33519,1145385,58454,4881913
2262,2021-01-04,AR,1231,341180,0,259,59647,0,0,2021-01-04,AR,23443,2640399,2959,649404,26402,3289803
2263,2021-01-04,AR,1231,341180,0,259,59647,0,0,2021-01-04,AR,52432,1587063,5896,442581,58328,2029644
2264,2021-01-04,AR,1231,341180,0,259,59647,0,0,2021-01-04,AR,18328,1074590,13295,167166,31623,1241756
2265,2021-01-04,AR,1231,341180,0,259,59647,0,0,2021-01-04,AR,6988,545501,13,99128,7001,644629
2266,2021-01-04,AR,1231,341180,0,259,59647,0,0,2021-01-04,AR,13754,175139,1912,47992,15666,223131
2267,2021-01-04,AR,1231,341180,0,259,59647,0,0,2021-01-04,AR,1402,43545,2573,24127,3975,67672
2268,2021-01-04,AR,1231,341180,0,259,59647,0,0,2021-01-04,AR,1465,7942,1,1,1466,7943
2269,2021-01-16,AR,933,353554,0,206,62448,0,0,2021-01-16,AR,7079,5380014,15512,4539001,22591,9919015
2270,2021-01-16,AR,933,353554,0,206,62448,0,0,2021-01-16,AR,8512,5171323,32414,4017676,40926,9188999
2271,2021-01-16,AR,933,353554,0,206,62448,0,0,2021-01-16,AR,18446,4490524,16736,3562264,35182,8052788
2272,2021-01-16,AR,933,353554,0,206,62448,0,0,2021-01-16,AR,5319,4154361,44365,2839403,49684,6993764
2273,2021-01-16,AR,933,353554,0,206,62448,0,0,2021-01-16,AR,6467,3874372,20690,1565278,27157,5439650
2274,2021-01-16,AR,933,353554,0,206,62448,0,0,2021-01-16,AR,50166,3150376,13614,767009,63780,3917385
2275,2021-01-16,AR,933,353554,0,206,62448,0,0,2021-01-16,AR,30311,1988040,10102,523912,40413,2511952
2276,2021-01-16,AR,933,353554,0,206,62448,0,0,2021-01-16,AR,3405,1188691,5587,302126,8992,1490817
2277,2021-01-16,AR,933,353554,0,206,62448,0,0,2021-01-16,AR,16979,816464,1218,116960,18197,933424
2278,2021-01-16,AR,933,353554,0,206,62448,0,0,2021-01-16,AR,15374,321710,3032,72979,18406,394689
2279,2021-01-16,AR,933,353554,0,206,62448,0,0,2021-01-16,AR,106,53386,30,34608,136,87994
2280,2021-01-16,AR,933,353554,0,206,62448,0,0,2021-01-16,AR,840,31743,0,8,840,31751
2281,2021-01-04,AR,687,368695,0,145,65669,0,0,2021-01-04,AR,4249,5305681,9117,4367302,13366,9672983
2282,2021-01-04,AR,687,368695,0,145,65669,0,0,2021-01-04,AR,25158,5037548,21486,3829509,46644,8867057
2283,2021-01-04,AR,687,368695,0,145,65669,0,0,2021-01-04,AR,8899,4286944,23759,3351805,32658,7638749
2284,2021-01-04,AR,687,368695,0,145,65669,0,0,2021-01-04,AR,5812,4087780,39069,2387531,44881,6475311
2285,2021-01-04,AR,687,368695,0,145,65669,0,0,2021-01-04,AR,24935,3736528,33519,1145385,58454,4881913
2286,2021-01-04,AR,687,368695,0,145,65669,0,0,2021-01-04,AR,23443,2640399,2959,649404,26402,3289803
2287,2021-01-04,AR,687,368695,0,145,65669,0,0,2021-01-04,AR,52432,1587063,5896,442581,58328,2029644
2288,2021-01-04,AR,687,368695,0,145,65669,0,0,2021-01-04,AR,18328,1074590,13295,167166,31623,1241756
2289,2021-01-04,AR,687,368695,0,145,65669,0,0,2021-01-04,AR,6988,545501,13,99128,7001,644629
2290,2021-01-04,AR,687,368695,0,145,65669,0,0,2021-01-04,AR,13754,175139,1912,47992,15666,223131
2291,2021-01-04,AR,687,368695,0,145,65669,0,0,2021-01-04,AR,1402,43545,2573,24127,3975,67672
2292,2021-01-04,AR,687,368695,0,145,65669,0,0,2021-01-04,AR,1465,7942,1,1,1466,7943
2293,2021-01-16,AR,708,378454,0,137,67582,0,0,2021-01-16,AR,7079,5380014,15512,4539001,22591,9919015
2294,2021-01-16,AR,708,378454,0,137,67582,0,0,2021-01-16,AR,8512,5171323,32414,4017676,40926,9188999
2295,2021-01-16,AR,708,378454,0,137,67582,0,0,2021-01-16,AR,18446,4490524,16736,3562264,35182,8052788
2296,2021-01-16,AR,708,378454,0,137,67582,0,0,2021-01-16,AR,5319,4154361,44365,2839403,49684,6993764
2297,2021-01-16,AR,708,378454,0,137,67582,0,0,2021-01-16,AR,6467,3874372,20690,1565278,27157,5439650
2298,2021-01-16,AR,708,378454,0,137,67582,0,0,2021-01-16,AR,50166,3150376,13614,767009,63780,3917385
2299,2021-01-16,AR,708,378454,0,137,67582,0,0,2021-01-16,AR,30311,1988040,10102,523912,40413,2511952
2300,2021-01-16,AR,708,378454,0,137,67582,0,0,2021-01-16,AR,3405,1188691,5587,302126,8992,1490817
2301,2021-01-16,AR,708,378454,0,137,67582,0,0,2021-01-16,AR,16979,816464,1218,116960,18197,933424
2302,2021-01-16,AR,708,378454,0,137,67582,0,0,2021-01-16,AR,15374,321710,3032,72979,18406,394689
2303,2021-01-16,AR,708,378454,0,137,67582,0,0,2021-01-16,AR,106,53386,30,34608,136,87994
2304,2021-01-16,AR,708,378454,0,137,67582,0,0,2021-01-16,AR,840,31743,0,8,840,31751
2305,2021-01-04,AR,661,390944,0,113,69930,0,0,2021-01-04,AR,4249,5305681,9117,4367302,13366,9672983
2306,2021-01-04,AR,661,390944,0,113,69930,0,0,2021-01-04,AR,25158,5037548,21486,3829509,46644,8867057
2307,2021-01-04,AR,661,390944,0,113,69930,0,0,2021-01-04,AR,8899,4286944,23759,3351805,32658,7638749
2308,2021-01-04,AR,661,390944,0,113,69930,0,0,2021-01-04,AR,5812,4087780,39069,2387531,44881,6475311
2309,2021-01-04,AR,661,390944,0,113,69930,0,0,2021-01-04,AR,24935,3736528,33519,1145385,58454,4881913
2310,2021-01-04,AR,661,390944,0,113,69930,0,0,2021-01-04,AR,23443,2640399,2959,649404,26402,3289803
2311,2021-01-04,AR,661,390944,0,113,69930,0,0,2021-01-04,AR,52432,1587063,5896,442581,58328,2029644
2312,2021-01-04,AR,661,390944,0,113,69930,0,0,2021-01-04,AR,18328,1074590,13295,167166,31623,1241756
2313,2021-01-04,AR,661,390944,0,113,69930,0,0,2021-01-04,AR,6988,545501,13,99128,7001,644629
2314,2021-01-04,AR,661,390944,0,113,69930,0,0,2021-01-04,AR,13754,175139,1912,47992,15666,223131
2315,2021-01-04,AR,661,390944,0,113,69930,0,0,2021-01-04,AR,1402,43545,2573,24127,3975,67672
2316,2021-01-04,AR,661,390944,0,113,69930,0,0,2021-01-04,AR,1465,7942,1,1,1466,7943
2317,2021-01-16,AR,473,397468,0,91,71167,0,0,2021-01-16,AR,7079,5380014,15512,4539001,22591,9919015
2318,2021-01-16,AR,473,397468,0,91,71167,0,0,2021-01-16,AR,8512,5171323,32414,4017676,40926,9188999
2319,2021-01-16,AR,473,397468,0,91,71167,0,0,2021-01-16,AR,18446,4490524,16736,3562264,35182,8052788
2320,2021-01-16,AR,473,397468,0,91,71167,0,0,2021-01-16,AR,5319,4154361,44365,2839403,49684,6993764
2321,2021-01-16,AR,473,397468,0,91,71167,0,0,2021-01-16,AR,6467,3874372,20690,1565278,27157,5439650
2322,2021-01-16,AR,473,397468,0,91,71167,0,0,2021-01-16,AR,50166,3150376,13614,767009,63780,3917385
2323,2021-01-16,AR,473,397468,0,91,71167,0,0,2021-01-16,AR,30311,1988040,10102,523912,40413,2511952
2324,2021-01-16,AR,473,397468,0,91,71167,0,0,2021-01-16,AR,3405,1188691,5587,302126,8992,1490817
2325,2021-01-16,AR,473,397468,0,91,71167,0,0,2021-01-16,AR,16979,816464,1218,116960,18197,933424
2326,2021-01-16,AR,473,397468,0,91,71167,0,0,2021-01-16,AR,15374,321710,3032,72979,18406,394689
2327,2021-01-16,AR,473,397468,0,91,71167,0,0,2021-01-16,AR,106,53386,30,34608,136,87994
2328,2021-01-16,AR,473,397468,0,91,71167,0,0,2021-01-16,AR,840,31743,0,8,840,31751
2329,2021-01-04,AR,312,406418,0,45,72549,0,0,2021-01-04,AR,4249,5305681,9117,4367302,13366,9672983
2330,2021-01-04,AR,312,406418,0,45,72549,0,0,2021-01-04,AR,25158,5037548,21486,3829509,46644,8867057
2331,2021-01-04,AR,312,406418,0,45,72549,0,0,2021-01-04,AR,8899,4286944,23759,3351805,32658,7638749
2332,2021-01-04,AR,312,406418,0,45,72549,0,0,2021-01-04,AR,5812,4087780,39069,2387531,44881,6475311
2333,2021-01-04,AR,312,406418,0,45,72549,0,0,2021-01-04,AR,24935,3736528,33519,1145385,58454,4881913
2334,2021-01-04,AR,312,406418,0,45,72549,0,0,2021-01-04,AR,23443,2640399,2959,649404,26402,3289803
2335,2021-01-04,AR,312,406418,0,45,72549,0,0,2021-01-04,AR,52432,1587063,5896,442581,58328,2029644
2336,2021-01-04,AR,312,406418,0,45,72549,0,0,2021-01-04,AR,18328,1074590,13295,167166,31623,1241756
2337,2021-01-04,AR,312,406418,0,45,72549,0,0,2021-01-04,AR,6988,545501,13,99128,7001,644629
2338,2021-01-04,AR,312,406418,0,45,72549,0,0,2021-01-04,AR,13754,175139,1912,47992,15666,223131
2339,2021-01-04,AR,312,406418,0,45,72549,0,0,2021-01-04,AR,1402,43545,2573,24127,3975,67672
2340,2021-01-04,AR,312,406418,0,45,72549,0,0,2021-01-04,AR,1465,7942,1,1,1466,7943
2341,2021-01-16,AR,321,410704,0,45,73150,0,0,2021-01-16,AR,7079,5380014,15512,4539001,22591,9919015
2342,2021-01-16,AR,321,410704,0,45,73150,0,0,2021-01-16,AR,8512,5171323,32414,4017676,40926,9188999
2343,2021-01-16,AR,321,410704,0,45,73150,0,0,2021-01-16,AR,18446,4490524,16736,3562264,35182,8052788
2344,2021-01-16,AR,321,410704,0,45,73150,0,0,2021-01-16,AR,5319,4154361,44365,2839403,49684,6993764
2345,2021-01-16,AR,321,410704,0,45,73150,0,0,2021-01-16,AR,6467,3874372,20690,1565278,27157,5439650
2346,2021-01-16,AR,321,410704,0,45,73150,0,0,2021-01-16,AR,50166,3150376,13614,767009,63780,3917385
2347,2021-01-16,AR,321,410704,0,45,73150,0,0,2021-01-16,AR,30311,1988040,10102,523912,40413,2511952
2348,2021-01-16,AR,321,410704,0,45,73150,0,0,2021-01-16,AR,3405,1188691,5587,302126,8992,1490817
2349,2021-01-16,AR,321,410704,0,45,73150,0,0,2021-01-16,AR,16979,816464,1218,116960,18197,933424
2350,2021-01-16,AR,321,410704,0,45,73150,0,0,2021-01-16,AR,15374,321710,3032,72979,18406,394689
2351,2021-01-16,AR,321,410704,0,45,73150,0,0,2021-01-16,AR,106,53386,30,34608,136,87994
2352,2021-01-16,AR,321,410704,0,45,73150,0,0,2021-01-16,AR,840,31743,0,8,840,31751
2353,2021-01-04,AR,315,415833,0,29,73760,0,0,2021-01-04,AR,4249,5305681,9117,4367302,13366,9672983
2354,2021-01-04,AR,315,415833,0,29,73760,0,0,2021-01-04,AR,25158,5037548,21486,3829509,46644,8867057
2355,2021-01-04,AR,315,415833,0,29,73760,0,0,2021-01-04,AR,8899,4286944,23759,3351805,32658,7638749
2356,2021-01-04,AR,315,415833,0,29,73760,0,0,2021-01-04,AR,5812,4087780,39069,2387531,44881,6475311
2357,2021-01-04,AR,315,415833,0,29,73760,0,0,2021-01-04,AR,24935,3736528,33519,1145385,58454,4881913
2358,2021-01-04,AR,315,415833,0,29,73760,0,0,2021-01-04,AR,23443,2640399,2959,649404,26402,3289803
2359,2021-01-04,AR,315,415833,0,29,73760,0,0,2021-01-04,AR,52432,1587063,5896,442581,58328,2029644
2360,2021-01-04,AR,315,415833,0,29,73760,0,0,2021-01-04,AR,18328,1074590,13295,167166,31623,1241756
2361,2021-01-04,AR,315,415833,0,29,73760,0,0,2021-01-04,AR,6988,545501,13,99128,7001,644629
2362,2021-01-04,AR,315,415833,0,29,73760,0,0,2021-01-04,AR,13754,175139,1912,47992,15666,223131
2363,2021-01-04,AR,315,415833,0,29,73760,0,0,2021-01-04,AR,1402,43545,2573,24127,3975,67672
2364,2021-01-04,AR,315,415833,0,29,73760,0,0,2021-01-04,AR,1465,7942,1,1,1466,7943
2365,2021-01-16,AR,174,418856,0,18,74126,0,0,2021-01-16,AR,7079,5380014,15512,4539001,22591,9919015
2366,2021-01-16,AR,174,418856,0,18,74126,0,0,2021-01-16,AR,8512,5171323,32414,4017676,40926,9188999
2367,2021-01-16,AR,174,418856,0,18,74126,0,0,2021-01-16,AR,18446,4490524,16736,3562264,35182,8052788
2368,2021-01-16,AR,174,418856,0,18,74126,0,0,2021-01-16,AR,5319,4154361,44365,2839403,49684,6993764
2369,2021-01-16,AR,174,418856,0,18,74126,0,0,2021-01-16,AR,6467,3874372,20690,1565278,27157,5439650
2370,2021-01-16,AR,174,418856,0,18,74126,0,0,2021-01-16,AR,50166,3150376,13614,767009,63780,3917385
2371,2021-01-16,AR,174,418856,0,18,74126,0,0,2021-01-16,AR,30311,1988040,10102,523912,40413,2511952
2372,2021-01-16,AR,174,418856,0,18,74126,0,0,2021-01-16,AR,3405,1188691,5587,302126,8992,1490817
2373,2021-01-16,AR,174,418856,0,18,74126,0,0,2021-01-16,AR,16979,816464,1218,116960,18197,933424
2374,2021-01-16,AR,174,418856,0,18,74126,0,0,2021-01-16,AR,15374,321710,3032,72979,18406,394689
2375,2021-01-16,AR,174,418856,0,18,74126,0,0,2021-01-16,AR,106,53386,30,34608,136,87994
2376,2021-01-16,AR,174,418856,0,18,74126,0,0,2021-01-16,AR,840,31743,0,8,840,31751
2377,2021-01-04,AR,239,423686,0,33,74693,0,0,2021-01-04,AR,4249,5305681,9117,4367302,13366,9672983
2378,2021-01-04,AR,239,423686,0,33,74693,0,0,2021-01-04,AR,25158,5037548,21486,3829509,46644,8867057
2379,2021-01-04,AR,239,423686,0,33,74693,0,0,2021-01-04,AR,8899,4286944,23759,3351805,32658,7638749
2380,2021-01-04,AR,239,423686,0,33,74693,0,0,2021-01-04,AR,5812,4087780,39069,2387531,44881,6475311
2381,2021-01-04,AR,239,423686,0,33,74693,0,0,2021-01-04,AR,24935,3736528,33519,1145385,58454,4881913
2382,2021-01-04,AR,239,423686,0,33,74693,0,0,2021-01-04,AR,23443,2640399,2959,649404,26402,3289803
2383,2021-01-04,AR,239,423686,0,33,74693,0,0,2021-01-04,AR,52432,1587063,5896,442581,58328,2029644
2384,2021-01-04,AR,239,423686,0,33,74693,0,0,2021-01-04,AR,18328,1074590,13295,167166,31623,1241756
2385,2021-01-04,AR,239,423686,0,33,74693,0,0,2021-01-04,AR,6988,545501,13,99128,7001,644629
2386,2021-01-04,AR,239,423686,0,33,74693,0,0,2021-01-04,AR,13754,175139,1912,47992,15666,223131
2387,2021-01-04,AR,239,423686,0,33,74693,0,0,2021-01-04,AR,1402,43545,2573,24127,3975,67672
2388,2021-01-04,AR,239,423686,0,33,74693,0,0,2021-01-04,AR,1465,7942,1,1,1466,7943
2389,2021-01-16,AR,247,426340,0,38,75005,0,0,2021-01-16,AR,7079,5380014,15512,4539001,22591,9919015
2390,2021-01-16,AR,247,426340,0,38,75005,0,0,2021-01-16,AR,8512,5171323,32414,4017676,40926,9188999
2391,2021-01-16,AR,247,426340,0,38,75005,0,0,2021-01-16,AR,18446,4490524,16736,3562264,35182,8052788
2392,2021-01-16,AR,247,426340,0,38,75005,0,0,2021-01-16,AR,5319,4154361,44365,2839403,49684,6993764
2393,2021-01-16,AR,247,426340,0,38,75005,0,0,2021-01-16,AR,6467,3874372,20690,1565278,27157,5439650
2394,2021-01-16,AR,247,426340,0,38,75005,0,0,2021-01-16,AR,50166,3150376,13614,767009,63780,3917385
2395,2021-01-16,AR,247,426340,0,38,75005,0,0,2021-01-16,AR,30311,1988040,10102,523912,40413,2511952
2396,2021-01-16,AR,247,426340,0,38,75005,0,0,2021-01-16,AR,3405,1188691,5587,302126,8992,1490817
2397,2021-01-16,AR,247,426340,0,38,75005,0,0,2021-01-16,AR,16979,816464,1218,116960,18197,933424
2398,2021-01-16,AR,247,426340,0,38,75005,0,0,2021-01-16,AR,15374,321710,3032,72979,18406,394689
2399,2021-01-16,AR,247,426340,0,38,75005,0,0,2021-01-16,AR,106,53386,30,34608,136,87994
2400,2021-01-16,AR,247,426340,0,38,75005,0,0,2021-01-16,AR,840,31743,0,8,840,31751
2401,2021-01-04,AR,183,430242,0,32,75550,0,0,2021-01-04,AR,4249,5305681,9117,4367302,13366,9672983
2402,2021-01-04,AR,183,430242,0,32,75550,0,0,2021-01-04,AR,25158,5037548,21486,3829509,46644,8867057
2403,2021-01-04,AR,183,430242,0,32,75550,0,0,2021-01-04,AR,8899,4286944,23759,3351805,32658,7638749
2404,2021-01-04,AR,183,430242,0,32,75550,0,0,2021-01-04,AR,5812,4087780,39069,2387531,44881,6475311
2405,2021-01-04,AR,183,430242,0,32,75550,0,0,2021-01-04,AR,24935,3736528,33519,1145385,58454,4881913
2406,2021-01-04,AR,183,430242,0,32,75550,0,0,2021-01-04,AR,23443,2640399,2959,649404,26402,3289803
2407,2021-01-04,AR,183,430242,0,32,75550,0,0,2021-01-04,AR,52432,1587063,5896,442581,58328,2029644
2408,2021-01-04,AR,183,430242,0,32,75550,0,0,2021-01-04,AR,18328,1074590,13295,167166,31623,1241756
2409,2021-01-04,AR,183,430242,0,32,75550,0,0,2021-01-04,AR,6988,545501,13,99128,7001,644629
2410,2021-01-04,AR,183,430242,0,32,75550,0,0,2021-01-04,AR,13754,175139,1912,47992,15666,223131
2411,2021-01-04,AR,183,430242,0,32,75550,0,0,2021-01-04,AR,1402,43545,2573,24127,3975,67672
2412,2021-01-04,AR,183,430242,0,32,75550,0,0,2021-01-04,AR,1465,7942,1,1,1466,7943
2413,2021-01-16,AR,215,432929,0,37,75933,0,0,2021-01-16,AR,7079,5380014,15512,4539001,22591,9919015
2414,2021-01-16,AR,215,432929,0,37,75933,0,0,2021-01-16,AR,8512,5171323,32414,4017676,40926,9188999
2415,2021-01-16,AR,215,432929,0,37,75933,0,0,2021-01-16,AR,18446,4490524,16736,3562264,35182,8052788
2416,2021-01-16,AR,215,432929,0,37,75933,0,0,2021-01-16,AR,5319,4154361,44365,2839403,49684,6993764
2417,2021-01-16,AR,215,432929,0,37,75933,0,0,2021-01-16,AR,6467,3874372,20690,1565278,27157,5439650
2418,2021-01-16,AR,215,432929,0,37,75933,0,0,2021-01-16,AR,50166,3150376,13614,767009,63780,3917385
2419,2021-01-16,AR,215,432929,0,37,75933,0,0,2021-01-16,AR,30311,1988040,10102,523912,40413,2511952
2420,2021-01-16,AR,215,432929,0,37,75933,0,0,2021-01-16,AR,3405,1188691,5587,302126,8992,1490817
2421,2021-01-16,AR,215,432929,0,37,75933,0,0,2021-01-16,AR,16979,816464,1218,116960,18197,933424
2422,2021-01-16,AR,215,432929,0,37,75933,0,0,2021-01-16,AR,15374,321710,3032,72979,18406,394689
2423,2021-01-16,AR,215,432929,0,37,75933,0,0,2021-01-16,AR,106,53386,30,34608,136,87994
2424,2021-01-16,AR,215,432929,0,37,75933,0,0,2021-01-16,AR,840,31743,0,8,840,31751
2425,2021-01-31,AR,369,250619,0,79,40589,0,0,2021-01-31,AR,518,5457654,1069,4688009,1587,10145663
2426,2021-01-31,AR,369,250619,0,79,40589,0,0,2021-01-31,AR,16807,4946318,3473,3752721,20280,8699039
2427,2021-01-31,AR,369,250619,0,79,40589,0,0,2021-01-31,AR,13275,4050443,51690,2191724,64965,6242167
2428,2021-01-31,AR,369,250619,0,79,40589,0,0,2021-01-31,AR,16983,3645224,22142,1035557,39125,4680781
2429,2021-01-31,AR,369,250619,0,79,40589,0,0,2021-01-31,AR,34146,1416855,8699,417225,42845,1834080
2430,2021-01-31,AR,369,250619,0,79,40589,0,0,2021-01-31,AR,23731,502826,702,98640,24433,601466
2431,2021-01-31,AR,369,250619,0,79,40589,0,0,2021-01-31,AR,2,39694,94,14290,96,53984
2432,2021-01-31,AR,625,278414,0,103,46019,0,0,2021-01-31,AR,518,5457654,1069,4688009,1587,10145663
2433,2021-01-31,AR,625,278414,0,103,46019,0,0,2021-01-31,AR,16807,4946318,3473,3752721,20280,8699039
2434,2021-01-31,AR,625,278414,0,103,46019,0,0,2021-01-31,AR,13275,4050443,51690,2191724,64965,6242167
2435,2021-01-31,AR,625,278414,0,103,46019,0,0,2021-01-31,AR,16983,3645224,22142,1035557,39125,4680781
2436,2021-01-31,AR,625,278414,0,103,46019,0,0,2021-01-31,AR,34146,1416855,8699,417225,42845,1834080
2437,2021-01-31,AR,625,278414,0,103,46019,0,0,2021-01-31,AR,23731,502826,702,98640,24433,601466
2438,2021-01-31,AR,625,278414,0,103,46019,0,0,2021-01-31,AR,2,39694,94,14290,96,53984
2439,2021-01-31,AR,1293,336143,0,262,58580,0,0,2021-01-31,AR,518,5457654,1069,4688009,1587,10145663
2440,2021-01-31,AR,1293,336143,0,262,58580,0,0,2021-01-31,AR,16807,4946318,3473,3752721,20280,8699039
2441,2021-01-31,AR,1293,336143,0,262,58580,0,0,2021-01-31,AR,13275,4050443,51690,2191724,64965,6242167
2442,2021-01-31,AR,1293,336143,0,262,58580,0,0,2021-01-31,AR,16983,3645224,22142,1035557,39125,4680781
2443,2021-01-31,AR,1293,336143,0,262,58580,0,0,2021-01-31,AR,34146,1416855,8699,417225,42845,1834080
2444,2021-01-31,AR,1293,336143,0,262,58580,0,0,2021-01-31,AR,23731,502826,702,98640,24433,601466
2445,2021-01-31,AR,1293,336143,0,262,58580,0,0,2021-01-31,AR,2,39694,94,14290,96,53984
2446,2021-01-31,AR,545,388332,0,121,69469,0,0,2021-01-31,AR,518,5457654,1069,4688009,1587,10145663
2447,2021-01-31,AR,545,388332,0,121,69469,0,0,2021-01-31,AR,16807,4946318,3473,3752721,20280,8699039
2448,2021-01-31,AR,545,388332,0,121,69469,0,0,2021-01-31,AR,13275,4050443,51690,2191724,64965,6242167
2449,2021-01-31,AR,545,388332,0,121,69469,0,0,2021-01-31,AR,16983,3645224,22142,1035557,39125,4680781
2450,2021-01-31,AR,545,388332,0,121,69469,0,0,2021-01-31,AR,34146,1416855,8699,417225,42845,1834080
2451,2021-01-31,AR,545,388332,0,121,69469,0,0,2021-01-31,AR,23731,502826,702,98640,24433,601466
2452,2021-01-31,AR,545,388332,0,121,69469,0,0,2021-01-31,AR,2,39694,94,14290,96,53984
2453,2021-01-31,AR,545,404856,0,80,72318,0,0,2021-01-31,AR,518,5457654,1069,4688009,1587,10145663
2454,2021-01-31,AR,545,404856,0,80,72318,0,0,2021-01-31,AR,16807,4946318,3473,3752721,20280,8699039
2455,2021-01-31,AR,545,404856,0,80,72318,0,0,2021-01-31,AR,13275,4050443,51690,2191724,64965,6242167
2456,2021-01-31,AR,545,404856,0,80,72318,0,0,2021-01-31,AR,16983,3645224,22142,1035557,39125,4680781
2457,2021-01-31,AR,545,404856,0,80,72318,0,0,2021-01-31,AR,34146,1416855,8699,417225,42845,1834080
2458,2021-01-31,AR,545,404856,0,80,72318,0,0,2021-01-31,AR,23731,502826,702,98640,24433,601466
2459,2021-01-31,AR,545,404856,0,80,72318,0,0,2021-01-31,AR,2,39694,94,14290,96,53984
2460,2021-01-31,AR,197,422609,0,15,74560,0,0,2021-01-31,AR,518,5457654,1069,4688009,1587,10145663
2461,2021-01-31,AR,197,422609,0,15,74560,0,0,2021-01-31,AR,16807,4946318,3473,3752721,20280,8699039
2462,2021-01-31,AR,197,422609,0,15,74560,0,0,2021-01-31,AR,13275,4050443,51690,2191724,64965,6242167
2463,2021-01-31,AR,197,422609,0,15,74560,0,0,2021-01-31,AR,16983,3645224,22142,1035557,39125,4680781
2464,2021-01-31,AR,197,422609,0,15,74560,0,0,2021-01-31,AR,34146,1416855,8699,417225,42845,1834080
2465,2021-01-31,AR,197,422609,0,15,74560,0,0,2021-01-31,AR,23731,502826,702,98640,24433,601466
2466,2021-01-31,AR,197,422609,0,15,74560,0,0,2021-01-31,AR,2,39694,94,14290,96,53984
2467,2021-01-31,AR,284,436829,0,54,76571,0,0,2021-01-31,AR,518,5457654,1069,4688009,1587,10145663
2468,2021-01-31,AR,284,436829,0,54,76571,0,0,2021-01-31,AR,16807,4946318,3473,3752721,20280,8699039
2469,2021-01-31,AR,284,436829,0,54,76571,0,0,2021-01-31,AR,13275,4050443,51690,2191724,64965,6242167
2470,2021-01-31,AR,284,436829,0,54,76571,0,0,2021-01-31,AR,16983,3645224,22142,1035557,39125,4680781
2471,2021-01-31,AR,284,436829,0,54,76571,0,0,2021-01-31,AR,34146,1416855,8699,417225,42845,1834080
2472,2021-01-31,AR,284,436829,0,54,76571,0,0,2021-01-31,AR,23731,502826,702,98640,24433,601466
2473,2021-01-31,AR,284,436829,0,54,76571,0,0,2021-01-31,AR,2,39694,94,14290,96,53984
2474,2021-01-10,AR,557,239135,0,95,38307,0,0,2021-01-10,AR,7251,5345398,18180,4460531,25431,9805929
2475,2021-01-10,AR,557,239135,0,95,38307,0,0,2021-01-10,AR,12481,5124564,16531,3910235,29012,9034799
2476,2021-01-10,AR,557,239135,0,95,38307,0,0,2021-01-10,AR,1362,4330292,8780,3459309,10142,7789601
2477,2021-01-10,AR,557,239135,0,95,38307,0,0,2021-01-10,AR,6841,4126920,40650,2661541,47491,6788461
2478,2021-01-10,AR,557,239135,0,95,38307,0,0,2021-01-10,AR,15283,3824457,39143,1355494,54426,5179951
2479,2021-01-10,AR,557,239135,0,95,38307,0,0,2021-01-10,AR,40835,2878209,4224,732691,45059,3610900
2480,2021-01-10,AR,557,239135,0,95,38307,0,0,2021-01-10,AR,44186,1842930,2556,464307,46742,2307237
2481,2021-01-10,AR,557,239135,0,95,38307,0,0,2021-01-10,AR,11152,1150881,9395,216601,20547,1367482
2482,2021-01-10,AR,557,239135,0,95,38307,0,0,2021-01-10,AR,12386,704068,657,106135,13043,810203
2483,2021-01-10,AR,557,239135,0,95,38307,0,0,2021-01-10,AR,22064,250146,890,51954,22954,302100
2484,2021-01-10,AR,557,239135,0,95,38307,0,0,2021-01-10,AR,1570,51874,681,30568,2251,82442
2485,2021-01-10,AR,557,239135,0,95,38307,0,0,2021-01-10,AR,172,18800,0,5,172,18805
2486,2021-01-10,AR,482,255530,0,106,41572,0,0,2021-01-10,AR,7251,5345398,18180,4460531,25431,9805929
2487,2021-01-10,AR,482,255530,0,106,41572,0,0,2021-01-10,AR,12481,5124564,16531,3910235,29012,9034799
2488,2021-01-10,AR,482,255530,0,106,41572,0,0,2021-01-10,AR,1362,4330292,8780,3459309,10142,7789601
2489,2021-01-10,AR,482,255530,0,106,41572,0,0,2021-01-10,AR,6841,4126920,40650,2661541,47491,6788461
2490,2021-01-10,AR,482,255530,0,106,41572,0,0,2021-01-10,AR,15283,3824457,39143,1355494,54426,5179951
2491,2021-01-10,AR,482,255530,0,106,41572,0,0,2021-01-10,AR,40835,2878209,4224,732691,45059,3610900
2492,2021-01-10,AR,482,255530,0,106,41572,0,0,2021-01-10,AR,44186,1842930,2556,464307,46742,2307237
2493,2021-01-10,AR,482,255530,0,106,41572,0,0,2021-01-10,AR,11152,1150881,9395,216601,20547,1367482
2494,2021-01-10,AR,482,255530,0,106,41572,0,0,2021-01-10,AR,12386,704068,657,106135,13043,810203
2495,2021-01-10,AR,482,255530,0,106,41572,0,0,2021-01-10,AR,22064,250146,890,51954,22954,302100
2496,2021-01-10,AR,482,255530,0,106,41572,0,0,2021-01-10,AR,1570,51874,681,30568,2251,82442
2497,2021-01-10,AR,482,255530,0,106,41572,0,0,2021-01-10,AR,172,18800,0,5,172,18805
2498,2021-01-10,AR,538,267833,0,99,43898,0,0,2021-01-10,AR,7251,5345398,18180,4460531,25431,9805929
2499,2021-01-10,AR,538,267833,0,99,43898,0,0,2021-01-10,AR,12481,5124564,16531,3910235,29012,9034799
2500,2021-01-10,AR,538,267833,0,99,43898,0,0,2021-01-10,AR,1362,4330292,8780,3459309,10142,7789601
2501,2021-01-10,AR,538,267833,0,99,43898,0,0,2021-01-10,AR,6841,4126920,40650,2661541,47491,6788461
2502,2021-01-10,AR,538,267833,0,99,43898,0,0,2021-01-10,AR,15283,3824457,39143,1355494,54426,5179951
2503,2021-01-10,AR,538,267833,0,99,43898,0,0,2021-01-10,AR,40835,2878209,4224,732691,45059,3610900
2504,2021-01-10,AR,538,267833,0,99,43898,0,0,2021-01-10,AR,44186,1842930,2556,464307,46742,2307237
2505,2021-01-10,AR,538,267833,0,99,43898,0,0,2021-01-10,AR,11152,1150881,9395,216601,20547,1367482
2506,2021-01-10,AR,538,267833,0,99,43898,0,0,2021-01-10,AR,12386,704068,657,106135,13043,810203
2507,2021-01-10,AR,538,267833,0,99,43898,0,0,2021-01-10,AR,22064,250146,890,51954,22954,302100
2508,2021-01-10,AR,538,267833,0,99,43898,0,0,2021-01-10,AR,1570,51874,681,30568,2251,82442
2509,2021-01-10,AR,538,267833,0,99,43898,0,0,2021-01-10,AR,172,18800,0,5,172,18805
2510,2021-01-10,AR,727,285323,0,169,47486,0,0,2021-01-10,AR,7251,5345398,18180,4460531,25431,9805929
2511,2021-01-10,AR,727,285323,0,169,47486,0,0,2021-01-10,AR,12481,5124564,16531,3910235,29012,9034799
2512,2021-01-10,AR,727,285323,0,169,47486,0,0,2021-01-10,AR,1362,4330292,8780,3459309,10142,7789601
2513,2021-01-10,AR,727,285323,0,169,47486,0,0,2021-01-10,AR,6841,4126920,40650,2661541,47491,6788461
2514,2021-01-10,AR,727,285323,0,169,47486,0,0,2021-01-10,AR,15283,3824457,39143,1355494,54426,5179951
2515,2021-01-10,AR,727,285323,0,169,47486,0,0,2021-01-10,AR,40835,2878209,4224,732691,45059,3610900
2516,2021-01-10,AR,727,285323,0,169,47486,0,0,2021-01-10,AR,44186,1842930,2556,464307,46742,2307237
2517,2021-01-10,AR,727,285323,0,169,47486,0,0,2021-01-10,AR,11152,1150881,9395,216601,20547,1367482
2518,2021-01-10,AR,727,285323,0,169,47486,0,0,2021-01-10,AR,12386,704068,657,106135,13043,810203
2519,2021-01-10,AR,727,285323,0,169,47486,0,0,2021-01-10,AR,22064,250146,890,51954,22954,302100
2520,2021-01-10,AR,727,285323,0,169,47486,0,0,2021-01-10,AR,1570,51874,681,30568,2251,82442
2521,2021-01-10,AR,727,285323,0,169,47486,0,0,2021-01-10,AR,172,18800,0,5,172,18805
2522,2021-01-10,AR,1063,312676,0,241,53391,0,0,2021-01-10,AR,7251,5345398,18180,4460531,25431,9805929
2523,2021-01-10,AR,1063,312676,0,241,53391,0,0,2021-01-10,AR,12481,5124564,16531,3910235,29012,9034799
2524,2021-01-10,AR,1063,312676,0,241,53391,0,0,2021-01-10,AR,1362,4330292,8780,3459309,10142,7789601
2525,2021-01-10,AR,1063,312676,0,241,53391,0,0,2021-01-10,AR,6841,4126920,40650,2661541,47491,6788461
2526,2021-01-10,AR,1063,312676,0,241,53391,0,0,2021-01-10,AR,15283,3824457,39143,1355494,54426,5179951
2527,2021-01-10,AR,1063,312676,0,241,53391,0,0,2021-01-10,AR,40835,2878209,4224,732691,45059,3610900
2528,2021-01-10,AR,1063,312676,0,241,53391,0,0,2021-01-10,AR,44186,1842930,2556,464307,46742,2307237
2529,2021-01-10,AR,1063,312676,0,241,53391,0,0,2021-01-10,AR,11152,1150881,9395,216601,20547,1367482
2530,2021-01-10,AR,1063,312676,0,241,53391,0,0,2021-01-10,AR,12386,704068,657,106135,13043,810203
2531,2021-01-10,AR,1063,312676,0,241,53391,0,0,2021-01-10,AR,22064,250146,890,51954,22954,302100
2532,2021-01-10,AR,1063,312676,0,241,53391,0,0,2021-01-10,AR,1570,51874,681,30568,2251,82442
2533,2021-01-10,AR,1063,312676,0,241,53391,0,0,2021-01-10,AR,172,18800,0,5,172,18805
2534,2021-01-10,AR,1168,347807,0,251,61153,0,0,2021-01-10,AR,7251,5345398,18180,4460531,25431,9805929
2535,2021-01-10,AR,1168,347807,0,251,61153,0,0,2021-01-10,AR,12481,5124564,16531,3910235,29012,9034799
2536,2021-01-10,AR,1168,347807,0,251,61153,0,0,2021-01-10,AR,1362,4330292,8780,3459309,10142,7789601
2537,2021-01-10,AR,1168,347807,0,251,61153,0,0,2021-01-10,AR,6841,4126920,40650,2661541,47491,6788461
2538,2021-01-10,AR,1168,347807,0,251,61153,0,0,2021-01-10,AR,15283,3824457,39143,1355494,54426,5179951
2539,2021-01-10,AR,1168,347807,0,251,61153,0,0,2021-01-10,AR,40835,2878209,4224,732691,45059,3610900
2540,2021-01-10,AR,1168,347807,0,251,61153,0,0,2021-01-10,AR,44186,1842930,2556,464307,46742,2307237
2541,2021-01-10,AR,1168,347807,0,251,61153,0,0,2021-01-10,AR,11152,1150881,9395,216601,20547,1367482
2542,2021-01-10,AR,1168,347807,0,251,61153,0,0,2021-01-10,AR,12386,704068,657,106135,13043,810203
2543,2021-01-10,AR,1168,347807,0,251,61153,0,0,2021-01-10,AR,22064,250146,890,51954,22954,302100
2544,2021-01-10,AR,1168,347807,0,251,61153,0,0,2021-01-10,AR,1570,51874,681,30568,2251,82442
2545,2021-01-10,AR,1168,347807,0,251,61153,0,0,2021-01-10,AR,172,18800,0,5,172,18805
2546,2021-01-10,AR,669,373644,0,142,66661,0,0,2021-01-10,AR,7251,5345398,18180,4460531,25431,9805929
2547,2021-01-10,AR,669,373644,0,142,66661,0,0,2021-01-10,AR,12481,5124564,16531,3910235,29012,9034799
2548,2021-01-10,AR,669,373644,0,142,66661,0,0,2021-01-10,AR,1362,4330292,8780,3459309,10142,7789601
2549,2021-01-10,AR,669,373644,0,142,66661,0,0,2021-01-10,AR,6841,4126920,40650,2661541,47491,6788461
2550,2021-01-10,AR,669,373644,0,142,66661,0,0,2021-01-10,AR,15283,3824457,39143,1355494,54426,5179951
2551,2021-01-10,AR,669,373644,0,142,66661,0,0,2021-01-10,AR,40835,2878209,4224,732691,45059,3610900
2552,2021-01-10,AR,669,373644,0,142,66661,0,0,2021-01-10,AR,44186,1842930,2556,464307,46742,2307237
2553,2021-01-10,AR,669,373644,0,142,66661,0,0,2021-01-10,AR,11152,1150881,9395,216601,20547,1367482
2554,2021-01-10,AR,669,373644,0,142,66661,0,0,2021-01-10,AR,12386,704068,657,106135,13043,810203
2555,2021-01-10,AR,669,373644,0,142,66661,0,0,2021-01-10,AR,22064,250146,890,51954,22954,302100
2556,2021-01-10,AR,669,373644,0,142,66661,0,0,2021-01-10,AR,1570,51874,681,30568,2251,82442
2557,2021-01-10,AR,669,373644,0,142,66661,0,0,2021-01-10,AR,172,18800,0,5,172,18805
2558,2021-01-10,AR,630,394425,0,113,70604,0,0,2021-01-10,AR,7251,5345398,18180,4460531,25431,9805929
2559,2021-01-10,AR,630,394425,0,113,70604,0,0,2021-01-10,AR,12481,5124564,16531,3910235,29012,9034799
2560,2021-01-10,AR,630,394425,0,113,70604,0,0,2021-01-10,AR,1362,4330292,8780,3459309,10142,7789601
2561,2021-01-10,AR,630,394425,0,113,70604,0,0,2021-01-10,AR,6841,4126920,40650,2661541,47491,6788461
2562,2021-01-10,AR,630,394425,0,113,70604,0,0,2021-01-10,AR,15283,3824457,39143,1355494,54426,5179951
2563,2021-01-10,AR,630,394425,0,113,70604,0,0,2021-01-10,AR,40835,2878209,4224,732691,45059,3610900
2564,2021-01-10,AR,630,394425,0,113,70604,0,0,2021-01-10,AR,44186,1842930,2556,464307,46742,2307237
2565,2021-01-10,AR,630,394425,0,113,70604,0,0,2021-01-10,AR,11152,1150881,9395,216601,20547,1367482
2566,2021-01-10,AR,630,394425,0,113,70604,0,0,2021-01-10,AR,12386,704068,657,106135,13043,810203
2567,2021-01-10,AR,630,394425,0,113,70604,0,0,2021-01-10,AR,22064,250146,890,51954,22954,302100
2568,2021-01-10,AR,630,394425,0,113,70604,0,0,2021-01-10,AR,1570,51874,681,30568,2251,82442
2569,2021-01-10,AR,630,394425,0,113,70604,0,0,2021-01-10,AR,172,18800,0,5,172,18805
2570,2021-01-10,AR,377,408706,0,55,72897,0,0,2021-01-10,AR,7251,5345398,18180,4460531,25431,9805929
2571,2021-01-10,AR,377,408706,0,55,72897,0,0,2021-01-10,AR,12481,5124564,16531,3910235,29012,9034799
2572,2021-01-10,AR,377,408706,0,55,72897,0,0,2021-01-10,AR,1362,4330292,8780,3459309,10142,7789601
2573,2021-01-10,AR,377,408706,0,55,72897,0,0,2021-01-10,AR,6841,4126920,40650,2661541,47491,6788461
2574,2021-01-10,AR,377,408706,0,55,72897,0,0,2021-01-10,AR,15283,3824457,39143,1355494,54426,5179951
2575,2021-01-10,AR,377,408706,0,55,72897,0,0,2021-01-10,AR,40835,2878209,4224,732691,45059,3610900
2576,2021-01-10,AR,377,408706,0,55,72897,0,0,2021-01-10,AR,44186,1842930,2556,464307,46742,2307237
2577,2021-01-10,AR,377,408706,0,55,72897,0,0,2021-01-10,AR,11152,1150881,9395,216601,20547,1367482
2578,2021-01-10,AR,377,408706,0,55,72897,0,0,2021-01-10,AR,12386,704068,657,106135,13043,810203
2579,2021-01-10,AR,377,408706,0,55,72897,0,0,2021-01-10,AR,22064,250146,890,51954,22954,302100
2580,2021-01-10,AR,377,408706,0,55,72897,0,0,2021-01-10,AR,1570,51874,681,30568,2251,82442
2581,2021-01-10,AR,377,408706,0,55,72897,0,0,2021-01-10,AR,172,18800,0,5,172,18805
2582,2021-01-10,AR,198,417249,0,26,73939,0,0,2021-01-10,AR,7251,5345398,18180,4460531,25431,9805929
2583,2021-01-10,AR,198,417249,0,26,73939,0,0,2021-01-10,AR,12481,5124564,16531,3910235,29012,9034799
2584,2021-01-10,AR,198,417249,0,26,73939,0,0,2021-01-10,AR,1362,4330292,8780,3459309,10142,7789601
2585,2021-01-10,AR,198,417249,0,26,73939,0,0,2021-01-10,AR,6841,4126920,40650,2661541,47491,6788461
2586,2021-01-10,AR,198,417249,0,26,73939,0,0,2021-01-10,AR,15283,3824457,39143,1355494,54426,5179951
2587,2021-01-10,AR,198,417249,0,26,73939,0,0,2021-01-10,AR,40835,2878209,4224,732691,45059,3610900
2588,2021-01-10,AR,198,417249,0,26,73939,0,0,2021-01-10,AR,44186,1842930,2556,464307,46742,2307237
2589,2021-01-10,AR,198,417249,0,26,73939,0,0,2021-01-10,AR,11152,1150881,9395,216601,20547,1367482
2590,2021-01-10,AR,198,417249,0,26,73939,0,0,2021-01-10,AR,12386,704068,657,106135,13043,810203
2591,2021-01-10,AR,198,417249,0,26,73939,0,0,2021-01-10,AR,22064,250146,890,51954,22954,302100
2592,2021-01-10,AR,198,417249,0,26,73939,0,0,2021-01-10,AR,1570,51874,681,30568,2251,82442
2593,2021-01-10,AR,198,417249,0,26,73939,0,0,2021-01-10,AR,172,18800,0,5,172,18805
2594,2021-01-10,AR,237,424983,0,31,74856,0,0,2021-01-10,AR,7251,5345398,18180,4460531,25431,9805929
2595,2021-01-10,AR,237,424983,0,31,74856,0,0,2021-01-10,AR,12481,5124564,16531,3910235,29012,9034799
2596,2021-01-10,AR,237,424983,0,31,74856,0,0,2021-01-10,AR,1362,4330292,8780,3459309,10142,7789601
2597,2021-01-10,AR,237,424983,0,31,74856,0,0,2021-01-10,AR,6841,4126920,40650,2661541,47491,6788461
2598,2021-01-10,AR,237,424983,0,31,74856,0,0,2021-01-10,AR,15283,3824457,39143,1355494,54426,5179951
2599,2021-01-10,AR,237,424983,0,31,74856,0,0,2021-01-10,AR,40835,2878209,4224,732691,45059,3610900
2600,2021-01-10,AR,237,424983,0,31,74856,0,0,2021-01-10,AR,44186,1842930,2556,464307,46742,2307237
2601,2021-01-10,AR,237,424983,0,31,74856,0,0,2021-01-10,AR,11152,1150881,9395,216601,20547,1367482
2602,2021-01-10,AR,237,424983,0,31,74856,0,0,2021-01-10,AR,12386,704068,657,106135,13043,810203
2603,2021-01-10,AR,237,424983,0,31,74856,0,0,2021-01-10,AR,22064,250146,890,51954,22954,302100
2604,2021-01-10,AR,237,424983,0,31,74856,0,0,2021-01-10,AR,1570,51874,681,30568,2251,82442
2605,2021-01-10,AR,237,424983,0,31,74856,0,0,2021-01-10,AR,172,18800,0,5,172,18805
2606,2021-01-10,AR,212,431579,0,18,75718,0,0,2021-01-10,AR,7251,5345398,18180,4460531,25431,9805929
2607,2021-01-10,AR,212,431579,0,18,75718,0,0,2021-01-10,AR,12481,5124564,16531,3910235,29012,9034799
2608,2021-01-10,AR,212,431579,0,18,75718,0,0,2021-01-10,AR,1362,4330292,8780,3459309,10142,7789601
2609,2021-01-10,AR,212,431579,0,18,75718,0,0,2021-01-10,AR,6841,4126920,40650,2661541,47491,6788461
2610,2021-01-10,AR,212,431579,0,18,75718,0,0,2021-01-10,AR,15283,3824457,39143,1355494,54426,5179951
2611,2021-01-10,AR,212,431579,0,18,75718,0,0,2021-01-10,AR,40835,2878209,4224,732691,45059,3610900
2612,2021-01-10,AR,212,431579,0,18,75718,0,0,2021-01-10,AR,44186,1842930,2556,464307,46742,2307237
2613,2021-01-10,AR,212,431579,0,18,75718,0,0,2021-01-10,AR,11152,1150881,9395,216601,20547,1367482
2614,2021-01-10,AR,212,431579,0,18,75718,0,0,2021-01-10,AR,12386,704068,657,106135,13043,810203
2615,2021-01-10,AR,212,431579,0,18,75718,0,0,2021-01-10,AR,22064,250146,890,51954,22954,302100
2616,2021-01-10,AR,212,431579,0,18,75718,0,0,2021-01-10,AR,1570,51874,681,30568,2251,82442
2617,2021-01-10,AR,212,431579,0,18,75718,0,0,2021-01-10,AR,172,18800,0,5,172,18805
2618,2021-01-15,AR,574,242243,0,116,38891,0,0,2021-01-15,AR,7041,5372935,16422,4523489,23463,9896424
2619,2021-01-15,AR,574,242243,0,116,38891,0,0,2021-01-15,AR,7394,5162811,28115,3985262,35509,9148073
2620,2021-01-15,AR,574,242243,0,116,38891,0,0,2021-01-15,AR,36841,4472078,22972,3545528,59813,8017606
2621,2021-01-15,AR,574,242243,0,116,38891,0,0,2021-01-15,AR,4934,4149042,40054,2795038,44988,6944080
2622,2021-01-15,AR,574,242243,0,116,38891,0,0,2021-01-15,AR,4299,3867905,18577,1544588,22876,5412493
2623,2021-01-15,AR,574,242243,0,116,38891,0,0,2021-01-15,AR,49799,3100210,7079,753395,56878,3853605
2624,2021-01-15,AR,574,242243,0,116,38891,0,0,2021-01-15,AR,24620,1957729,12164,513810,36784,2471539
2625,2021-01-15,AR,574,242243,0,116,38891,0,0,2021-01-15,AR,5763,1185286,7114,296539,12877,1481825
2626,2021-01-15,AR,574,242243,0,116,38891,0,0,2021-01-15,AR,19059,799485,2804,115742,21863,915227
2627,2021-01-15,AR,574,242243,0,116,38891,0,0,2021-01-15,AR,15189,306336,3941,69947,19130,376283
2628,2021-01-15,AR,574,242243,0,116,38891,0,0,2021-01-15,AR,150,53280,27,34578,177,87858
2629,2021-01-15,AR,574,242243,0,116,38891,0,0,2021-01-15,AR,2440,30903,2,8,2442,30911
2630,2021-01-15,AR,388,257610,0,65,41972,0,0,2021-01-15,AR,7041,5372935,16422,4523489,23463,9896424
2631,2021-01-15,AR,388,257610,0,65,41972,0,0,2021-01-15,AR,7394,5162811,28115,3985262,35509,9148073
2632,2021-01-15,AR,388,257610,0,65,41972,0,0,2021-01-15,AR,36841,4472078,22972,3545528,59813,8017606
2633,2021-01-15,AR,388,257610,0,65,41972,0,0,2021-01-15,AR,4934,4149042,40054,2795038,44988,6944080
2634,2021-01-15,AR,388,257610,0,65,41972,0,0,2021-01-15,AR,4299,3867905,18577,1544588,22876,5412493
2635,2021-01-15,AR,388,257610,0,65,41972,0,0,2021-01-15,AR,49799,3100210,7079,753395,56878,3853605
2636,2021-01-15,AR,388,257610,0,65,41972,0,0,2021-01-15,AR,24620,1957729,12164,513810,36784,2471539
2637,2021-01-15,AR,388,257610,0,65,41972,0,0,2021-01-15,AR,5763,1185286,7114,296539,12877,1481825
2638,2021-01-15,AR,388,257610,0,65,41972,0,0,2021-01-15,AR,19059,799485,2804,115742,21863,915227
2639,2021-01-15,AR,388,257610,0,65,41972,0,0,2021-01-15,AR,15189,306336,3941,69947,19130,376283
2640,2021-01-15,AR,388,257610,0,65,41972,0,0,2021-01-15,AR,150,53280,27,34578,177,87858
2641,2021-01-15,AR,388,257610,0,65,41972,0,0,2021-01-15,AR,2440,30903,2,8,2442,30911
2642,2021-01-15,AR,546,270124,0,110,44379,0,0,2021-01-15,AR,7041,5372935,16422,4523489,23463,9896424
2643,2021-01-15,AR,546,270124,0,110,44379,0,0,2021-01-15,AR,7394,5162811,28115,3985262,35509,9148073
2644,2021-01-15,AR,546,270124,0,110,44379,0,0,2021-01-15,AR,36841,4472078,22972,3545528,59813,8017606
2645,2021-01-15,AR,546,270124,0,110,44379,0,0,2021-01-15,AR,4934,4149042,40054,2795038,44988,6944080
2646,2021-01-15,AR,546,270124,0,110,44379,0,0,2021-01-15,AR,4299,3867905,18577,1544588,22876,5412493
2647,2021-01-15,AR,546,270124,0,110,44379,0,0,2021-01-15,AR,49799,3100210,7079,753395,56878,3853605
2648,2021-01-15,AR,546,270124,0,110,44379,0,0,2021-01-15,AR,24620,1957729,12164,513810,36784,2471539
2649,2021-01-15,AR,546,270124,0,110,44379,0,0,2021-01-15,AR,5763,1185286,7114,296539,12877,1481825
2650,2021-01-15,AR,546,270124,0,110,44379,0,0,2021-01-15,AR,19059,799485,2804,115742,21863,915227
2651,2021-01-15,AR,546,270124,0,110,44379,0,0,2021-01-15,AR,15189,306336,3941,69947,19130,376283
2652,2021-01-15,AR,546,270124,0,110,44379,0,0,2021-01-15,AR,150,53280,27,34578,177,87858
2653,2021-01-15,AR,546,270124,0,110,44379,0,0,2021-01-15,AR,2440,30903,2,8,2442,30911
2654,2021-01-15,AR,929,289837,0,177,48380,0,0,2021-01-15,AR,7041,5372935,16422,4523489,23463,9896424
2655,2021-01-15,AR,929,289837,0,177,48380,0,0,2021-01-15,AR,7394,5162811,28115,3985262,35509,9148073
2656,2021-01-15,AR,929,289837,0,177,48380,0,0,2021-01-15,AR,36841,4472078,22972,3545528,59813,8017606
2657,2021-01-15,AR,929,289837,0,177,48380,0,0,2021-01-15,AR,4934,4149042,40054,2795038,44988,6944080
2658,2021-01-15,AR,929,289837,0,177,48380,0,0,2021-01-15,AR,4299,3867905,18577,1544588,22876,5412493
2659,2021-01-15,AR,929,289837,0,177,48380,0,0,2021-01-15,AR,49799,3100210,7079,753395,56878,3853605
2660,2021-01-15,AR,929,289837,0,177,48380,0,0,2021-01-15,AR,24620,1957729,12164,513810,36784,2471539
2661,2021-01-15,AR,929,289837,0,177,48380,0,0,2021-01-15,AR,5763,1185286,7114,296539,12877,1481825
2662,2021-01-15,AR,929,289837,0,177,48380,0,0,2021-01-15,AR,19059,799485,2804,115742,21863,915227
2663,2021-01-15,AR,929,289837,0,177,48380,0,0,2021-01-15,AR,15189,306336,3941,69947,19130,376283
2664,2021-01-15,AR,929,289837,0,177,48380,0,0,2021-01-15,AR,150,53280,27,34578,177,87858
2665,2021-01-15,AR,929,289837,0,177,48380,0,0,2021-01-15,AR,2440,30903,2,8,2442,30911
2666,2021-01-15,AR,935,317721,0,210,54480,0,0,2021-01-15,AR,7041,5372935,16422,4523489,23463,9896424
2667,2021-01-15,AR,935,317721,0,210,54480,0,0,2021-01-15,AR,7394,5162811,28115,3985262,35509,9148073
2668,2021-01-15,AR,935,317721,0,210,54480,0,0,2021-01-15,AR,36841,4472078,22972,3545528,59813,8017606
2669,2021-01-15,AR,935,317721,0,210,54480,0,0,2021-01-15,AR,4934,4149042,40054,2795038,44988,6944080
2670,2021-01-15,AR,935,317721,0,210,54480,0,0,2021-01-15,AR,4299,3867905,18577,1544588,22876,5412493
2671,2021-01-15,AR,935,317721,0,210,54480,0,0,2021-01-15,AR,49799,3100210,7079,753395,56878,3853605
2672,2021-01-15,AR,935,317721,0,210,54480,0,0,2021-01-15,AR,24620,1957729,12164,513810,36784,2471539
2673,2021-01-15,AR,935,317721,0,210,54480,0,0,2021-01-15,AR,5763,1185286,7114,296539,12877,1481825
2674,2021-01-15,AR,935,317721,0,210,54480,0,0,2021-01-15,AR,19059,799485,2804,115742,21863,915227
2675,2021-01-15,AR,935,317721,0,210,54480,0,0,2021-01-15,AR,15189,306336,3941,69947,19130,376283
2676,2021-01-15,AR,935,317721,0,210,54480,0,0,2021-01-15,AR,150,53280,27,34578,177,87858
2677,2021-01-15,AR,935,317721,0,210,54480,0,0,2021-01-15,AR,2440,30903,2,8,2442,30911
2678,2021-01-15,AR,987,352621,0,218,62242,0,0,2021-01-15,AR,7041,5372935,16422,4523489,23463,9896424
2679,2021-01-15,AR,987,352621,0,218,62242,0,0,2021-01-15,AR,7394,5162811,28115,3985262,35509,9148073
2680,2021-01-15,AR,987,352621,0,218,62242,0,0,2021-01-15,AR,36841,4472078,22972,3545528,59813,8017606
2681,2021-01-15,AR,987,352621,0,218,62242,0,0,2021-01-15,AR,4934,4149042,40054,2795038,44988,6944080
2682,2021-01-15,AR,987,352621,0,218,62242,0,0,2021-01-15,AR,4299,3867905,18577,1544588,22876,5412493
2683,2021-01-15,AR,987,352621,0,218,62242,0,0,2021-01-15,AR,49799,3100210,7079,753395,56878,3853605
2684,2021-01-15,AR,987,352621,0,218,62242,0,0,2021-01-15,AR,24620,1957729,12164,513810,36784,2471539
2685,2021-01-15,AR,987,352621,0,218,62242,0,0,2021-01-15,AR,5763,1185286,7114,296539,12877,1481825
2686,2021-01-15,AR,987,352621,0,218,62242,0,0,2021-01-15,AR,19059,799485,2804,115742,21863,915227
2687,2021-01-15,AR,987,352621,0,218,62242,0,0,2021-01-15,AR,15189,306336,3941,69947,19130,376283
2688,2021-01-15,AR,987,352621,0,218,62242,0,0,2021-01-15,AR,150,53280,27,34578,177,87858
2689,2021-01-15,AR,987,352621,0,218,62242,0,0,2021-01-15,AR,2440,30903,2,8,2442,30911
2690,2021-01-15,AR,732,377746,0,164,67445,0,0,2021-01-15,AR,7041,5372935,16422,4523489,23463,9896424
2691,2021-01-15,AR,732,377746,0,164,67445,0,0,2021-01-15,AR,7394,5162811,28115,3985262,35509,9148073
2692,2021-01-15,AR,732,377746,0,164,67445,0,0,2021-01-15,AR,36841,4472078,22972,3545528,59813,8017606
2693,2021-01-15,AR,732,377746,0,164,67445,0,0,2021-01-15,AR,4934,4149042,40054,2795038,44988,6944080
2694,2021-01-15,AR,732,377746,0,164,67445,0,0,2021-01-15,AR,4299,3867905,18577,1544588,22876,5412493
2695,2021-01-15,AR,732,377746,0,164,67445,0,0,2021-01-15,AR,49799,3100210,7079,753395,56878,3853605
2696,2021-01-15,AR,732,377746,0,164,67445,0,0,2021-01-15,AR,24620,1957729,12164,513810,36784,2471539
2697,2021-01-15,AR,732,377746,0,164,67445,0,0,2021-01-15,AR,5763,1185286,7114,296539,12877,1481825
2698,2021-01-15,AR,732,377746,0,164,67445,0,0,2021-01-15,AR,19059,799485,2804,115742,21863,915227
2699,2021-01-15,AR,732,377746,0,164,67445,0,0,2021-01-15,AR,15189,306336,3941,69947,19130,376283
2700,2021-01-15,AR,732,377746,0,164,67445,0,0,2021-01-15,AR,150,53280,27,34578,177,87858
2701,2021-01-15,AR,732,377746,0,164,67445,0,0,2021-01-15,AR,2440,30903,2,8,2442,30911
2702,2021-01-15,AR,439,396995,0,95,71076,0,0,2021-01-15,AR,7041,5372935,16422,4523489,23463,9896424
2703,2021-01-15,AR,439,396995,0,95,71076,0,0,2021-01-15,AR,7394,5162811,28115,3985262,35509,9148073
2704,2021-01-15,AR,439,396995,0,95,71076,0,0,2021-01-15,AR,36841,4472078,22972,3545528,59813,8017606
2705,2021-01-15,AR,439,396995,0,95,71076,0,0,2021-01-15,AR,4934,4149042,40054,2795038,44988,6944080
2706,2021-01-15,AR,439,396995,0,95,71076,0,0,2021-01-15,AR,4299,3867905,18577,1544588,22876,5412493
2707,2021-01-15,AR,439,396995,0,95,71076,0,0,2021-01-15,AR,49799,3100210,7079,753395,56878,3853605
2708,2021-01-15,AR,439,396995,0,95,71076,0,0,2021-01-15,AR,24620,1957729,12164,513810,36784,2471539
2709,2021-01-15,AR,439,396995,0,95,71076,0,0,2021-01-15,AR,5763,1185286,7114,296539,12877,1481825
2710,2021-01-15,AR,439,396995,0,95,71076,0,0,2021-01-15,AR,19059,799485,2804,115742,21863,915227
2711,2021-01-15,AR,439,396995,0,95,71076,0,0,2021-01-15,AR,15189,306336,3941,69947,19130,376283
2712,2021-01-15,AR,439,396995,0,95,71076,0,0,2021-01-15,AR,150,53280,27,34578,177,87858
2713,2021-01-15,AR,439,396995,0,95,71076,0,0,2021-01-15,AR,2440,30903,2,8,2442,30911
2714,2021-01-15,AR,348,410383,0,39,73105,0,0,2021-01-15,AR,7041,5372935,16422,4523489,23463,9896424
2715,2021-01-15,AR,348,410383,0,39,73105,0,0,2021-01-15,AR,7394,5162811,28115,3985262,35509,9148073
2716,2021-01-15,AR,348,410383,0,39,73105,0,0,2021-01-15,AR,36841,4472078,22972,3545528,59813,8017606
2717,2021-01-15,AR,348,410383,0,39,73105,0,0,2021-01-15,AR,4934,4149042,40054,2795038,44988,6944080
2718,2021-01-15,AR,348,410383,0,39,73105,0,0,2021-01-15,AR,4299,3867905,18577,1544588,22876,5412493
2719,2021-01-15,AR,348,410383,0,39,73105,0,0,2021-01-15,AR,49799,3100210,7079,753395,56878,3853605
2720,2021-01-15,AR,348,410383,0,39,73105,0,0,2021-01-15,AR,24620,1957729,12164,513810,36784,2471539
2721,2021-01-15,AR,348,410383,0,39,73105,0,0,2021-01-15,AR,5763,1185286,7114,296539,12877,1481825
2722,2021-01-15,AR,348,410383,0,39,73105,0,0,2021-01-15,AR,19059,799485,2804,115742,21863,915227
2723,2021-01-15,AR,348,410383,0,39,73105,0,0,2021-01-15,AR,15189,306336,3941,69947,19130,376283
2724,2021-01-15,AR,348,410383,0,39,73105,0,0,2021-01-15,AR,150,53280,27,34578,177,87858
2725,2021-01-15,AR,348,410383,0,39,73105,0,0,2021-01-15,AR,2440,30903,2,8,2442,30911
2726,2021-01-15,AR,245,418682,0,30,74108,0,0,2021-01-15,AR,7041,5372935,16422,4523489,23463,9896424
2727,2021-01-15,AR,245,418682,0,30,74108,0,0,2021-01-15,AR,7394,5162811,28115,3985262,35509,9148073
2728,2021-01-15,AR,245,418682,0,30,74108,0,0,2021-01-15,AR,36841,4472078,22972,3545528,59813,8017606
2729,2021-01-15,AR,245,418682,0,30,74108,0,0,2021-01-15,AR,4934,4149042,40054,2795038,44988,6944080
2730,2021-01-15,AR,245,418682,0,30,74108,0,0,2021-01-15,AR,4299,3867905,18577,1544588,22876,5412493
2731,2021-01-15,AR,245,418682,0,30,74108,0,0,2021-01-15,AR,49799,3100210,7079,753395,56878,3853605
2732,2021-01-15,AR,245,418682,0,30,74108,0,0,2021-01-15,AR,24620,1957729,12164,513810,36784,2471539
2733,2021-01-15,AR,245,418682,0,30,74108,0,0,2021-01-15,AR,5763,1185286,7114,296539,12877,1481825
2734,2021-01-15,AR,245,418682,0,30,74108,0,0,2021-01-15,AR,19059,799485,2804,115742,21863,915227
2735,2021-01-15,AR,245,418682,0,30,74108,0,0,2021-01-15,AR,15189,306336,3941,69947,19130,376283
2736,2021-01-15,AR,245,418682,0,30,74108,0,0,2021-01-15,AR,150,53280,27,34578,177,87858
2737,2021-01-15,AR,245,418682,0,30,74108,0,0,2021-01-15,AR,2440,30903,2,8,2442,30911
2738,2021-01-15,AR,288,426093,0,27,74967,0,0,2021-01-15,AR,7041,5372935,16422,4523489,23463,9896424
2739,2021-01-15,AR,288,426093,0,27,74967,0,0,2021-01-15,AR,7394,5162811,28115,3985262,35509,9148073
2740,2021-01-15,AR,288,426093,0,27,74967,0,0,2021-01-15,AR,36841,4472078,22972,3545528,59813,8017606
2741,2021-01-15,AR,288,426093,0,27,74967,0,0,2021-01-15,AR,4934,4149042,40054,2795038,44988,6944080
2742,2021-01-15,AR,288,426093,0,27,74967,0,0,2021-01-15,AR,4299,3867905,18577,1544588,22876,5412493
2743,2021-01-15,AR,288,426093,0,27,74967,0,0,2021-01-15,AR,49799,3100210,7079,753395,56878,3853605
2744,2021-01-15,AR,288,426093,0,27,74967,0,0,2021-01-15,AR,24620,1957729,12164,513810,36784,2471539
2745,2021-01-15,AR,288,426093,0,27,74967,0,0,2021-01-15,AR,5763,1185286,7114,296539,12877,1481825
2746,2021-01-15,AR,288,426093,0,27,74967,0,0,2021-01-15,AR,19059,799485,2804,115742,21863,915227
2747,2021-01-15,AR,288,426093,0,27,74967,0,0,2021-01-15,AR,15189,306336,3941,69947,19130,376283
2748,2021-01-15,AR,288,426093,0,27,74967,0,0,2021-01-15,AR,150,53280,27,34578,177,87858
2749,2021-01-15,AR,288,426093,0,27,74967,0,0,2021-01-15,AR,2440,30903,2,8,2442,30911
2750,2021-01-15,AR,244,432714,0,50,75896,0,0,2021-01-15,AR,7041,5372935,16422,4523489,23463,9896424
2751,2021-01-15,AR,244,432714,0,50,75896,0,0,2021-01-15,AR,7394,5162811,28115,3985262,35509,9148073
2752,2021-01-15,AR,244,432714,0,50,75896,0,0,2021-01-15,AR,36841,4472078,22972,3545528,59813,8017606
2753,2021-01-15,AR,244,432714,0,50,75896,0,0,2021-01-15,AR,4934,4149042,40054,2795038,44988,6944080
2754,2021-01-15,AR,244,432714,0,50,75896,0,0,2021-01-15,AR,4299,3867905,18577,1544588,22876,5412493
2755,2021-01-15,AR,244,432714,0,50,75896,0,0,2021-01-15,AR,49799,3100210,7079,753395,56878,3853605
2756,2021-01-15,AR,244,432714,0,50,75896,0,0,2021-01-15,AR,24620,1957729,12164,513810,36784,2471539
2757,2021-01-15,AR,244,432714,0,50,75896,0,0,2021-01-15,AR,5763,1185286,7114,296539,12877,1481825
2758,2021-01-15,AR,244,432714,0,50,75896,0,0,2021-01-15,AR,19059,799485,2804,115742,21863,915227
2759,2021-01-15,AR,244,432714,0,50,75896,0,0,2021-01-15,AR,15189,306336,3941,69947,19130,376283
2760,2021-01-15,AR,244,432714,0,50,75896,0,0,2021-01-15,AR,150,53280,27,34578,177,87858
2761,2021-01-15,AR,244,432714,0,50,75896,0,0,2021-01-15,AR,2440,30903,2,8,2442,30911
2762,2021-01-29,AR,529,249859,0,110,40434,0,0,2021-01-29,AR,10075,5448843,16203,4673488,26278,10122331
2763,2021-01-29,AR,529,249859,0,110,40434,0,0,2021-01-29,AR,8800,5260217,24742,4276394,33542,9536611
2764,2021-01-29,AR,529,249859,0,110,40434,0,0,2021-01-29,AR,28163,4919485,13838,3743524,42001,8663009
2765,2021-01-29,AR,529,249859,0,110,40434,0,0,2021-01-29,AR,7177,4252893,29483,3215383,36660,7468276
2766,2021-01-29,AR,529,249859,0,110,40434,0,0,2021-01-29,AR,3173,4024329,20538,2093570,23711,6117899
2767,2021-01-29,AR,529,249859,0,110,40434,0,0,2021-01-29,AR,32689,3597283,27918,983986,60607,4581269
2768,2021-01-29,AR,529,249859,0,110,40434,0,0,2021-01-29,AR,46378,2438014,7072,599217,53450,3037231
2769,2021-01-29,AR,529,249859,0,110,40434,0,0,2021-01-29,AR,23540,1367060,8733,406180,32273,1773240
2770,2021-01-29,AR,529,249859,0,110,40434,0,0,2021-01-29,AR,17509,1025626,4330,136588,21839,1162214
2771,2021-01-29,AR,529,249859,0,110,40434,0,0,2021-01-29,AR,17526,456261,671,97219,18197,553480
2772,2021-01-29,AR,529,249859,0,110,40434,0,0,2021-01-29,AR,197,39672,3090,13048,3287,52720
2773,2021-01-29,AR,601,277176,0,120,45780,0,0,2021-01-29,AR,10075,5448843,16203,4673488,26278,10122331
2774,2021-01-29,AR,601,277176,0,120,45780,0,0,2021-01-29,AR,8800,5260217,24742,4276394,33542,9536611
2775,2021-01-29,AR,601,277176,0,120,45780,0,0,2021-01-29,AR,28163,4919485,13838,3743524,42001,8663009
2776,2021-01-29,AR,601,277176,0,120,45780,0,0,2021-01-29,AR,7177,4252893,29483,3215383,36660,7468276
2777,2021-01-29,AR,601,277176,0,120,45780,0,0,2021-01-29,AR,3173,4024329,20538,2093570,23711,6117899
2778,2021-01-29,AR,601,277176,0,120,45780,0,0,2021-01-29,AR,32689,3597283,27918,983986,60607,4581269
2779,2021-01-29,AR,601,277176,0,120,45780,0,0,2021-01-29,AR,46378,2438014,7072,599217,53450,3037231
2780,2021-01-29,AR,601,277176,0,120,45780,0,0,2021-01-29,AR,23540,1367060,8733,406180,32273,1773240
2781,2021-01-29,AR,601,277176,0,120,45780,0,0,2021-01-29,AR,17509,1025626,4330,136588,21839,1162214
2782,2021-01-29,AR,601,277176,0,120,45780,0,0,2021-01-29,AR,17526,456261,671,97219,18197,553480
2783,2021-01-29,AR,601,277176,0,120,45780,0,0,2021-01-29,AR,197,39672,3090,13048,3287,52720
2784,2021-01-29,AR,922,302899,0,209,51181,0,0,2021-01-29,AR,10075,5448843,16203,4673488,26278,10122331
2785,2021-01-29,AR,922,302899,0,209,51181,0,0,2021-01-29,AR,8800,5260217,24742,4276394,33542,9536611
2786,2021-01-29,AR,922,302899,0,209,51181,0,0,2021-01-29,AR,28163,4919485,13838,3743524,42001,8663009
2787,2021-01-29,AR,922,302899,0,209,51181,0,0,2021-01-29,AR,7177,4252893,29483,3215383,36660,7468276
2788,2021-01-29,AR,922,302899,0,209,51181,0,0,2021-01-29,AR,3173,4024329,20538,2093570,23711,6117899
2789,2021-01-29,AR,922,302899,0,209,51181,0,0,2021-01-29,AR,32689,3597283,27918,983986,60607,4581269
2790,2021-01-29,AR,922,302899,0,209,51181,0,0,2021-01-29,AR,46378,2438014,7072,599217,53450,3037231
2791,2021-01-29,AR,922,302899,0,209,51181,0,0,2021-01-29,AR,23540,1367060,8733,406180,32273,1773240
2792,2021-01-29,AR,922,302899,0,209,51181,0,0,2021-01-29,AR,17509,1025626,4330,136588,21839,1162214
2793,2021-01-29,AR,922,302899,0,209,51181,0,0,2021-01-29,AR,17526,456261,671,97219,18197,553480
2794,2021-01-29,AR,922,302899,0,209,51181,0,0,2021-01-29,AR,197,39672,3090,13048,3287,52720
2795,2021-01-29,AR,1104,333836,0,262,58047,0,0,2021-01-29,AR,10075,5448843,16203,4673488,26278,10122331
2796,2021-01-29,AR,1104,333836,0,262,58047,0,0,2021-01-29,AR,8800,5260217,24742,4276394,33542,9536611
2797,2021-01-29,AR,1104,333836,0,262,58047,0,0,2021-01-29,AR,28163,4919485,13838,3743524,42001,8663009
2798,2021-01-29,AR,1104,333836,0,262,58047,0,0,2021-01-29,AR,7177,4252893,29483,3215383,36660,7468276
2799,2021-01-29,AR,1104,333836,0,262,58047,0,0,2021-01-29,AR,3173,4024329,20538,2093570,23711,6117899
2800,2021-01-29,AR,1104,333836,0,262,58047,0,0,2021-01-29,AR,32689,3597283,27918,983986,60607,4581269
2801,2021-01-29,AR,1104,333836,0,262,58047,0,0,2021-01-29,AR,46378,2438014,7072,599217,53450,3037231
2802,2021-01-29,AR,1104,333836,0,262,58047,0,0,2021-01-29,AR,23540,1367060,8733,406180,32273,1773240
2803,2021-01-29,AR,1104,333836,0,262,58047,0,0,2021-01-29,AR,17509,1025626,4330,136588,21839,1162214
2804,2021-01-29,AR,1104,333836,0,262,58047,0,0,2021-01-29,AR,17526,456261,671,97219,18197,553480
2805,2021-01-29,AR,1104,333836,0,262,58047,0,0,2021-01-29,AR,197,39672,3090,13048,3287,52720
2806,2021-01-29,AR,855,364670,0,167,64864,0,0,2021-01-29,AR,10075,5448843,16203,4673488,26278,10122331
2807,2021-01-29,AR,855,364670,0,167,64864,0,0,2021-01-29,AR,8800,5260217,24742,4276394,33542,9536611
2808,2021-01-29,AR,855,364670,0,167,64864,0,0,2021-01-29,AR,28163,4919485,13838,3743524,42001,8663009
2809,2021-01-29,AR,855,364670,0,167,64864,0,0,2021-01-29,AR,7177,4252893,29483,3215383,36660,7468276
2810,2021-01-29,AR,855,364670,0,167,64864,0,0,2021-01-29,AR,3173,4024329,20538,2093570,23711,6117899
2811,2021-01-29,AR,855,364670,0,167,64864,0,0,2021-01-29,AR,32689,3597283,27918,983986,60607,4581269
2812,2021-01-29,AR,855,364670,0,167,64864,0,0,2021-01-29,AR,46378,2438014,7072,599217,53450,3037231
2813,2021-01-29,AR,855,364670,0,167,64864,0,0,2021-01-29,AR,23540,1367060,8733,406180,32273,1773240
2814,2021-01-29,AR,855,364670,0,167,64864,0,0,2021-01-29,AR,17509,1025626,4330,136588,21839,1162214
2815,2021-01-29,AR,855,364670,0,167,64864,0,0,2021-01-29,AR,17526,456261,671,97219,18197,553480
2816,2021-01-29,AR,855,364670,0,167,64864,0,0,2021-01-29,AR,197,39672,3090,13048,3287,52720
2817,2021-01-29,AR,616,387145,0,109,69231,0,0,2021-01-29,AR,10075,5448843,16203,4673488,26278,10122331
2818,2021-01-29,AR,616,387145,0,109,69231,0,0,2021-01-29,AR,8800,5260217,24742,4276394,33542,9536611
2819,2021-01-29,AR,616,387145,0,109,69231,0,0,2021-01-29,AR,28163,4919485,13838,3743524,42001,8663009
2820,2021-01-29,AR,616,387145,0,109,69231,0,0,2021-01-29,AR,7177,4252893,29483,3215383,36660,7468276
2821,2021-01-29,AR,616,387145,0,109,69231,0,0,2021-01-29,AR,3173,4024329,20538,2093570,23711,6117899
2822,2021-01-29,AR,616,387145,0,109,69231,0,0,2021-01-29,AR,32689,3597283,27918,983986,60607,4581269
2823,2021-01-29,AR,616,387145,0,109,69231,0,0,2021-01-29,AR,46378,2438014,7072,599217,53450,3037231
2824,2021-01-29,AR,616,387145,0,109,69231,0,0,2021-01-29,AR,23540,1367060,8733,406180,32273,1773240
2825,2021-01-29,AR,616,387145,0,109,69231,0,0,2021-01-29,AR,17509,1025626,4330,136588,21839,1162214
2826,2021-01-29,AR,616,387145,0,109,69231,0,0,2021-01-29,AR,17526,456261,671,97219,18197,553480
2827,2021-01-29,AR,616,387145,0,109,69231,0,0,2021-01-29,AR,197,39672,3090,13048,3287,52720
2828,2021-01-29,AR,379,403750,0,54,72174,0,0,2021-01-29,AR,10075,5448843,16203,4673488,26278,10122331
2829,2021-01-29,AR,379,403750,0,54,72174,0,0,2021-01-29,AR,8800,5260217,24742,4276394,33542,9536611
2830,2021-01-29,AR,379,403750,0,54,72174,0,0,2021-01-29,AR,28163,4919485,13838,3743524,42001,8663009
2831,2021-01-29,AR,379,403750,0,54,72174,0,0,2021-01-29,AR,7177,4252893,29483,3215383,36660,7468276
2832,2021-01-29,AR,379,403750,0,54,72174,0,0,2021-01-29,AR,3173,4024329,20538,2093570,23711,6117899
2833,2021-01-29,AR,379,403750,0,54,72174,0,0,2021-01-29,AR,32689,3597283,27918,983986,60607,4581269
2834,2021-01-29,AR,379,403750,0,54,72174,0,0,2021-01-29,AR,46378,2438014,7072,599217,53450,3037231
2835,2021-01-29,AR,379,403750,0,54,72174,0,0,2021-01-29,AR,23540,1367060,8733,406180,32273,1773240
2836,2021-01-29,AR,379,403750,0,54,72174,0,0,2021-01-29,AR,17509,1025626,4330,136588,21839,1162214
2837,2021-01-29,AR,379,403750,0,54,72174,0,0,2021-01-29,AR,17526,456261,671,97219,18197,553480
2838,2021-01-29,AR,379,403750,0,54,72174,0,0,2021-01-29,AR,197,39672,3090,13048,3287,52720
2839,2021-01-29,AR,310,414534,0,33,73602,0,0,2021-01-29,AR,10075,5448843,16203,4673488,26278,10122331
2840,2021-01-29,AR,310,414534,0,33,73602,0,0,2021-01-29,AR,8800,5260217,24742,4276394,33542,9536611
2841,2021-01-29,AR,310,414534,0,33,73602,0,0,2021-01-29,AR,28163,4919485,13838,3743524,42001,8663009
2842,2021-01-29,AR,310,414534,0,33,73602,0,0,2021-01-29,AR,7177,4252893,29483,3215383,36660,7468276
2843,2021-01-29,AR,310,414534,0,33,73602,0,0,2021-01-29,AR,3173,4024329,20538,2093570,23711,6117899
2844,2021-01-29,AR,310,414534,0,33,73602,0,0,2021-01-29,AR,32689,3597283,27918,983986,60607,4581269
2845,2021-01-29,AR,310,414534,0,33,73602,0,0,2021-01-29,AR,46378,2438014,7072,599217,53450,3037231
2846,2021-01-29,AR,310,414534,0,33,73602,0,0,2021-01-29,AR,23540,1367060,8733,406180,32273,1773240
2847,2021-01-29,AR,310,414534,0,33,73602,0,0,2021-01-29,AR,17509,1025626,4330,136588,21839,1162214
2848,2021-01-29,AR,310,414534,0,33,73602,0,0,2021-01-29,AR,17526,456261,671,97219,18197,553480
2849,2021-01-29,AR,310,414534,0,33,73602,0,0,2021-01-29,AR,197,39672,3090,13048,3287,52720
2850,2021-01-29,AR,270,422208,0,34,74528,0,0,2021-01-29,AR,10075,5448843,16203,4673488,26278,10122331
2851,2021-01-29,AR,270,422208,0,34,74528,0,0,2021-01-29,AR,8800,5260217,24742,4276394,33542,9536611
2852,2021-01-29,AR,270,422208,0,34,74528,0,0,2021-01-29,AR,28163,4919485,13838,3743524,42001,8663009
2853,2021-01-29,AR,270,422208,0,34,74528,0,0,2021-01-29,AR,7177,4252893,29483,3215383,36660,7468276
2854,2021-01-29,AR,270,422208,0,34,74528,0,0,2021-01-29,AR,3173,4024329,20538,2093570,23711,6117899
2855,2021-01-29,AR,270,422208,0,34,74528,0,0,2021-01-29,AR,32689,3597283,27918,983986,60607,4581269
2856,2021-01-29,AR,270,422208,0,34,74528,0,0,2021-01-29,AR,46378,2438014,7072,599217,53450,3037231
2857,2021-01-29,AR,270,422208,0,34,74528,0,0,2021-01-29,AR,23540,1367060,8733,406180,32273,1773240
2858,2021-01-29,AR,270,422208,0,34,74528,0,0,2021-01-29,AR,17509,1025626,4330,136588,21839,1162214
2859,2021-01-29,AR,270,422208,0,34,74528,0,0,2021-01-29,AR,17526,456261,671,97219,18197,553480
2860,2021-01-29,AR,270,422208,0,34,74528,0,0,2021-01-29,AR,197,39672,3090,13048,3287,52720
2861,2021-01-29,AR,242,429118,0,32,75415,0,0,2021-01-29,AR,10075,5448843,16203,4673488,26278,10122331
2862,2021-01-29,AR,242,429118,0,32,75415,0,0,2021-01-29,AR,8800,5260217,24742,4276394,33542,9536611
2863,2021-01-29,AR,242,429118,0,32,75415,0,0,2021-01-29,AR,28163,4919485,13838,3743524,42001,8663009
2864,2021-01-29,AR,242,429118,0,32,75415,0,0,2021-01-29,AR,7177,4252893,29483,3215383,36660,7468276
2865,2021-01-29,AR,242,429118,0,32,75415,0,0,2021-01-29,AR,3173,4024329,20538,2093570,23711,6117899
2866,2021-01-29,AR,242,429118,0,32,75415,0,0,2021-01-29,AR,32689,3597283,27918,983986,60607,4581269
2867,2021-01-29,AR,242,429118,0,32,75415,0,0,2021-01-29,AR,46378,2438014,7072,599217,53450,3037231
2868,2021-01-29,AR,242,429118,0,32,75415,0,0,2021-01-29,AR,23540,1367060,8733,406180,32273,1773240
2869,2021-01-29,AR,242,429118,0,32,75415,0,0,2021-01-29,AR,17509,1025626,4330,136588,21839,1162214
2870,2021-01-29,AR,242,429118,0,32,75415,0,0,2021-01-29,AR,17526,456261,671,97219,18197,553480
2871,2021-01-29,AR,242,429118,0,32,75415,0,0,2021-01-29,AR,197,39672,3090,13048,3287,52720
2872,2021-01-29,AR,368,436209,0,50,76456,0,0,2021-01-29,AR,10075,5448843,16203,4673488,26278,10122331
2873,2021-01-29,AR,368,436209,0,50,76456,0,0,2021-01-29,AR,8800,5260217,24742,4276394,33542,9536611
2874,2021-01-29,AR,368,436209,0,50,76456,0,0,2021-01-29,AR,28163,4919485,13838,3743524,42001,8663009
2875,2021-01-29,AR,368,436209,0,50,76456,0,0,2021-01-29,AR,7177,4252893,29483,3215383,36660,7468276
2876,2021-01-29,AR,368,436209,0,50,76456,0,0,2021-01-29,AR,3173,4024329,20538,2093570,23711,6117899
2877,2021-01-29,AR,368,436209,0,50,76456,0,0,2021-01-29,AR,32689,3597283,27918,983986,60607,4581269
2878,2021-01-29,AR,368,436209,0,50,76456,0,0,2021-01-29,AR,46378,2438014,7072,599217,53450,3037231
2879,2021-01-29,AR,368,436209,0,50,76456,0,0,2021-01-29,AR,23540,1367060,8733,406180,32273,1773240
2880,2021-01-29,AR,368,436209,0,50,76456,0,0,2021-01-29,AR,17509,1025626,4330,136588,21839,1162214
2881,2021-01-29,AR,368,436209,0,50,76456,0,0,2021-01-29,AR,17526,456261,671,97219,18197,553480
2882,2021-01-29,AR,368,436209,0,50,76456,0,0,2021-01-29,AR,197,39672,3090,13048,3287,52720
2883,2021-01-11,AR,619,239754,0,116,38423,0,0,2021-01-11,AR,3972,5349370,8244,4468775,12216,9818145
2884,2021-01-11,AR,619,239754,0,116,38423,0,0,2021-01-11,AR,13431,5137995,15725,3925960,29156,9063955
2885,2021-01-11,AR,619,239754,0,116,38423,0,0,2021-01-11,AR,2124,4332416,7629,3466938,9753,7799354
2886,2021-01-11,AR,619,239754,0,116,38423,0,0,2021-01-11,AR,3505,4130425,24193,2685734,27698,6816159
2887,2021-01-11,AR,619,239754,0,116,38423,0,0,2021-01-11,AR,12974,3837431,45385,1400879,58359,5238310
2888,2021-01-11,AR,619,239754,0,116,38423,0,0,2021-01-11,AR,21336,2899545,984,733675,22320,3633220
2889,2021-01-11,AR,619,239754,0,116,38423,0,0,2021-01-11,AR,46307,1889237,6081,470388,52388,2359625
2890,2021-01-11,AR,619,239754,0,116,38423,0,0,2021-01-11,AR,10716,1161597,9382,225983,20098,1387580
2891,2021-01-11,AR,619,239754,0,116,38423,0,0,2021-01-11,AR,6441,710509,182,106317,6623,816826
2892,2021-01-11,AR,619,239754,0,116,38423,0,0,2021-01-11,AR,21317,271463,4409,56363,25726,327826
2893,2021-01-11,AR,619,239754,0,116,38423,0,0,2021-01-11,AR,603,52477,1925,32493,2528,84970
2894,2021-01-11,AR,619,239754,0,116,38423,0,0,2021-01-11,AR,2644,21444,1,6,2645,21450
2895,2021-01-11,AR,443,255973,0,94,41666,0,0,2021-01-11,AR,3972,5349370,8244,4468775,12216,9818145
2896,2021-01-11,AR,443,255973,0,94,41666,0,0,2021-01-11,AR,13431,5137995,15725,3925960,29156,9063955
2897,2021-01-11,AR,443,255973,0,94,41666,0,0,2021-01-11,AR,2124,4332416,7629,3466938,9753,7799354
2898,2021-01-11,AR,443,255973,0,94,41666,0,0,2021-01-11,AR,3505,4130425,24193,2685734,27698,6816159
2899,2021-01-11,AR,443,255973,0,94,41666,0,0,2021-01-11,AR,12974,3837431,45385,1400879,58359,5238310
2900,2021-01-11,AR,443,255973,0,94,41666,0,0,2021-01-11,AR,21336,2899545,984,733675,22320,3633220
2901,2021-01-11,AR,443,255973,0,94,41666,0,0,2021-01-11,AR,46307,1889237,6081,470388,52388,2359625
2902,2021-01-11,AR,443,255973,0,94,41666,0,0,2021-01-11,AR,10716,1161597,9382,225983,20098,1387580
2903,2021-01-11,AR,443,255973,0,94,41666,0,0,2021-01-11,AR,6441,710509,182,106317,6623,816826
2904,2021-01-11,AR,443,255973,0,94,41666,0,0,2021-01-11,AR,21317,271463,4409,56363,25726,327826
2905,2021-01-11,AR,443,255973,0,94,41666,0,0,2021-01-11,AR,603,52477,1925,32493,2528,84970
2906,2021-01-11,AR,443,255973,0,94,41666,0,0,2021-01-11,AR,2644,21444,1,6,2645,21450
2907,2021-01-11,AR,476,268309,0,88,43986,0,0,2021-01-11,AR,3972,5349370,8244,4468775,12216,9818145
2908,2021-01-11,AR,476,268309,0,88,43986,0,0,2021-01-11,AR,13431,5137995,15725,3925960,29156,9063955
2909,2021-01-11,AR,476,268309,0,88,43986,0,0,2021-01-11,AR,2124,4332416,7629,3466938,9753,7799354
2910,2021-01-11,AR,476,268309,0,88,43986,0,0,2021-01-11,AR,3505,4130425,24193,2685734,27698,6816159
2911,2021-01-11,AR,476,268309,0,88,43986,0,0,2021-01-11,AR,12974,3837431,45385,1400879,58359,5238310
2912,2021-01-11,AR,476,268309,0,88,43986,0,0,2021-01-11,AR,21336,2899545,984,733675,22320,3633220
2913,2021-01-11,AR,476,268309,0,88,43986,0,0,2021-01-11,AR,46307,1889237,6081,470388,52388,2359625
2914,2021-01-11,AR,476,268309,0,88,43986,0,0,2021-01-11,AR,10716,1161597,9382,225983,20098,1387580
2915,2021-01-11,AR,476,268309,0,88,43986,0,0,2021-01-11,AR,6441,710509,182,106317,6623,816826
2916,2021-01-11,AR,476,268309,0,88,43986,0,0,2021-01-11,AR,21317,271463,4409,56363,25726,327826
2917,2021-01-11,AR,476,268309,0,88,43986,0,0,2021-01-11,AR,603,52477,1925,32493,2528,84970
2918,2021-01-11,AR,476,268309,0,88,43986,0,0,2021-01-11,AR,2644,21444,1,6,2645,21450
2919,2021-01-11,AR,687,286010,0,137,47623,0,0,2021-01-11,AR,3972,5349370,8244,4468775,12216,9818145
2920,2021-01-11,AR,687,286010,0,137,47623,0,0,2021-01-11,AR,13431,5137995,15725,3925960,29156,9063955
2921,2021-01-11,AR,687,286010,0,137,47623,0,0,2021-01-11,AR,2124,4332416,7629,3466938,9753,7799354
2922,2021-01-11,AR,687,286010,0,137,47623,0,0,2021-01-11,AR,3505,4130425,24193,2685734,27698,6816159
2923,2021-01-11,AR,687,286010,0,137,47623,0,0,2021-01-11,AR,12974,3837431,45385,1400879,58359,5238310
2924,2021-01-11,AR,687,286010,0,137,47623,0,0,2021-01-11,AR,21336,2899545,984,733675,22320,3633220
2925,2021-01-11,AR,687,286010,0,137,47623,0,0,2021-01-11,AR,46307,1889237,6081,470388,52388,2359625
2926,2021-01-11,AR,687,286010,0,137,47623,0,0,2021-01-11,AR,10716,1161597,9382,225983,20098,1387580
2927,2021-01-11,AR,687,286010,0,137,47623,0,0,2021-01-11,AR,6441,710509,182,106317,6623,816826
2928,2021-01-11,AR,687,286010,0,137,47623,0,0,2021-01-11,AR,21317,271463,4409,56363,25726,327826
2929,2021-01-11,AR,687,286010,0,137,47623,0,0,2021-01-11,AR,603,52477,1925,32493,2528,84970
2930,2021-01-11,AR,687,286010,0,137,47623,0,0,2021-01-11,AR,2644,21444,1,6,2645,21450
2931,2021-01-11,AR,998,313674,0,228,53619,0,0,2021-01-11,AR,3972,5349370,8244,4468775,12216,9818145
2932,2021-01-11,AR,998,313674,0,228,53619,0,0,2021-01-11,AR,13431,5137995,15725,3925960,29156,9063955
2933,2021-01-11,AR,998,313674,0,228,53619,0,0,2021-01-11,AR,2124,4332416,7629,3466938,9753,7799354
2934,2021-01-11,AR,998,313674,0,228,53619,0,0,2021-01-11,AR,3505,4130425,24193,2685734,27698,6816159
2935,2021-01-11,AR,998,313674,0,228,53619,0,0,2021-01-11,AR,12974,3837431,45385,1400879,58359,5238310
2936,2021-01-11,AR,998,313674,0,228,53619,0,0,2021-01-11,AR,21336,2899545,984,733675,22320,3633220
2937,2021-01-11,AR,998,313674,0,228,53619,0,0,2021-01-11,AR,46307,1889237,6081,470388,52388,2359625
2938,2021-01-11,AR,998,313674,0,228,53619,0,0,2021-01-11,AR,10716,1161597,9382,225983,20098,1387580
2939,2021-01-11,AR,998,313674,0,228,53619,0,0,2021-01-11,AR,6441,710509,182,106317,6623,816826
2940,2021-01-11,AR,998,313674,0,228,53619,0,0,2021-01-11,AR,21317,271463,4409,56363,25726,327826
2941,2021-01-11,AR,998,313674,0,228,53619,0,0,2021-01-11,AR,603,52477,1925,32493,2528,84970
2942,2021-01-11,AR,998,313674,0,228,53619,0,0,2021-01-11,AR,2644,21444,1,6,2645,21450
2943,2021-01-11,AR,996,348803,0,222,61375,0,0,2021-01-11,AR,3972,5349370,8244,4468775,12216,9818145
2944,2021-01-11,AR,996,348803,0,222,61375,0,0,2021-01-11,AR,13431,5137995,15725,3925960,29156,9063955
2945,2021-01-11,AR,996,348803,0,222,61375,0,0,2021-01-11,AR,2124,4332416,7629,3466938,9753,7799354
2946,2021-01-11,AR,996,348803,0,222,61375,0,0,2021-01-11,AR,3505,4130425,24193,2685734,27698,6816159
2947,2021-01-11,AR,996,348803,0,222,61375,0,0,2021-01-11,AR,12974,3837431,45385,1400879,58359,5238310
2948,2021-01-11,AR,996,348803,0,222,61375,0,0,2021-01-11,AR,21336,2899545,984,733675,22320,3633220
2949,2021-01-11,AR,996,348803,0,222,61375,0,0,2021-01-11,AR,46307,1889237,6081,470388,52388,2359625
2950,2021-01-11,AR,996,348803,0,222,61375,0,0,2021-01-11,AR,10716,1161597,9382,225983,20098,1387580
2951,2021-01-11,AR,996,348803,0,222,61375,0,0,2021-01-11,AR,6441,710509,182,106317,6623,816826
2952,2021-01-11,AR,996,348803,0,222,61375,0,0,2021-01-11,AR,21317,271463,4409,56363,25726,327826
2953,2021-01-11,AR,996,348803,0,222,61375,0,0,2021-01-11,AR,603,52477,1925,32493,2528,84970
2954,2021-01-11,AR,996,348803,0,222,61375,0,0,2021-01-11,AR,2644,21444,1,6,2645,21450
2955,2021-01-11,AR,666,374310,0,125,66786,0,0,2021-01-11,AR,3972,5349370,8244,4468775,12216,9818145
2956,2021-01-11,AR,666,374310,0,125,66786,0,0,2021-01-11,AR,13431,5137995,15725,3925960,29156,9063955
2957,2021-01-11,AR,666,374310,0,125,66786,0,0,2021-01-11,AR,2124,4332416,7629,3466938,9753,7799354
2958,2021-01-11,AR,666,374310,0,125,66786,0,0,2021-01-11,AR,3505,4130425,24193,2685734,27698,6816159
2959,2021-01-11,AR,666,374310,0,125,66786,0,0,2021-01-11,AR,12974,3837431,45385,1400879,58359,5238310
2960,2021-01-11,AR,666,374310,0,125,66786,0,0,2021-01-11,AR,21336,2899545,984,733675,22320,3633220
2961,2021-01-11,AR,666,374310,0,125,66786,0,0,2021-01-11,AR,46307,1889237,6081,470388,52388,2359625
2962,2021-01-11,AR,666,374310,0,125,66786,0,0,2021-01-11,AR,10716,1161597,9382,225983,20098,1387580
2963,2021-01-11,AR,666,374310,0,125,66786,0,0,2021-01-11,AR,6441,710509,182,106317,6623,816826
2964,2021-01-11,AR,666,374310,0,125,66786,0,0,2021-01-11,AR,21317,271463,4409,56363,25726,327826
2965,2021-01-11,AR,666,374310,0,125,66786,0,0,2021-01-11,AR,603,52477,1925,32493,2528,84970
2966,2021-01-11,AR,666,374310,0,125,66786,0,0,2021-01-11,AR,2644,21444,1,6,2645,21450
2967,2021-01-11,AR,597,395022,0,95,70699,0,0,2021-01-11,AR,3972,5349370,8244,4468775,12216,9818145
2968,2021-01-11,AR,597,395022,0,95,70699,0,0,2021-01-11,AR,13431,5137995,15725,3925960,29156,9063955
2969,2021-01-11,AR,597,395022,0,95,70699,0,0,2021-01-11,AR,2124,4332416,7629,3466938,9753,7799354
2970,2021-01-11,AR,597,395022,0,95,70699,0,0,2021-01-11,AR,3505,4130425,24193,2685734,27698,6816159
2971,2021-01-11,AR,597,395022,0,95,70699,0,0,2021-01-11,AR,12974,3837431,45385,1400879,58359,5238310
2972,2021-01-11,AR,597,395022,0,95,70699,0,0,2021-01-11,AR,21336,2899545,984,733675,22320,3633220
2973,2021-01-11,AR,597,395022,0,95,70699,0,0,2021-01-11,AR,46307,1889237,6081,470388,52388,2359625
2974,2021-01-11,AR,597,395022,0,95,70699,0,0,2021-01-11,AR,10716,1161597,9382,225983,20098,1387580
2975,2021-01-11,AR,597,395022,0,95,70699,0,0,2021-01-11,AR,6441,710509,182,106317,6623,816826
2976,2021-01-11,AR,597,395022,0,95,70699,0,0,2021-01-11,AR,21317,271463,4409,56363,25726,327826
2977,2021-01-11,AR,597,395022,0,95,70699,0,0,2021-01-11,AR,603,52477,1925,32493,2528,84970
2978,2021-01-11,AR,597,395022,0,95,70699,0,0,2021-01-11,AR,2644,21444,1,6,2645,21450
2979,2021-01-11,AR,264,408970,0,41,72938,0,0,2021-01-11,AR,3972,5349370,8244,4468775,12216,9818145
2980,2021-01-11,AR,264,408970,0,41,72938,0,0,2021-01-11,AR,13431,5137995,15725,3925960,29156,9063955
2981,2021-01-11,AR,264,408970,0,41,72938,0,0,2021-01-11,AR,2124,4332416,7629,3466938,9753,7799354
2982,2021-01-11,AR,264,408970,0,41,72938,0,0,2021-01-11,AR,3505,4130425,24193,2685734,27698,6816159
2983,2021-01-11,AR,264,408970,0,41,72938,0,0,2021-01-11,AR,12974,3837431,45385,1400879,58359,5238310
2984,2021-01-11,AR,264,408970,0,41,72938,0,0,2021-01-11,AR,21336,2899545,984,733675,22320,3633220
2985,2021-01-11,AR,264,408970,0,41,72938,0,0,2021-01-11,AR,46307,1889237,6081,470388,52388,2359625
2986,2021-01-11,AR,264,408970,0,41,72938,0,0,2021-01-11,AR,10716,1161597,9382,225983,20098,1387580
2987,2021-01-11,AR,264,408970,0,41,72938,0,0,2021-01-11,AR,6441,710509,182,106317,6623,816826
2988,2021-01-11,AR,264,408970,0,41,72938,0,0,2021-01-11,AR,21317,271463,4409,56363,25726,327826
2989,2021-01-11,AR,264,408970,0,41,72938,0,0,2021-01-11,AR,603,52477,1925,32493,2528,84970
2990,2021-01-11,AR,264,408970,0,41,72938,0,0,2021-01-11,AR,2644,21444,1,6,2645,21450
2991,2021-01-11,AR,234,417483,0,24,73963,0,0,2021-01-11,AR,3972,5349370,8244,4468775,12216,9818145
2992,2021-01-11,AR,234,417483,0,24,73963,0,0,2021-01-11,AR,13431,5137995,15725,3925960,29156,9063955
2993,2021-01-11,AR,234,417483,0,24,73963,0,0,2021-01-11,AR,2124,4332416,7629,3466938,9753,7799354
2994,2021-01-11,AR,234,417483,0,24,73963,0,0,2021-01-11,AR,3505,4130425,24193,2685734,27698,6816159
2995,2021-01-11,AR,234,417483,0,24,73963,0,0,2021-01-11,AR,12974,3837431,45385,1400879,58359,5238310
2996,2021-01-11,AR,234,417483,0,24,73963,0,0,2021-01-11,AR,21336,2899545,984,733675,22320,3633220
2997,2021-01-11,AR,234,417483,0,24,73963,0,0,2021-01-11,AR,46307,1889237,6081,470388,52388,2359625
2998,2021-01-11,AR,234,417483,0,24,73963,0,0,2021-01-11,AR,10716,1161597,9382,225983,20098,1387580
2999,2021-01-11,AR,234,417483,0,24,73963,0,0,2021-01-11,AR,6441,710509,182,106317,6623,816826
3000,2021-01-11,AR,234,417483,0,24,73963,0,0,2021-01-11,AR,21317,271463,4409,56363,25726,327826
3001,2021-01-11,AR,234,417483,0,24,73963,0,0,2021-01-11,AR,603,52477,1925,32493,2528,84970
3002,2021-01-11,AR,234,417483,0,24,73963,0,0,2021-01-11,AR,2644,21444,1,6,2645,21450
3003,2021-01-11,AR,235,425218,0,21,74877,0,0,2021-01-11,AR,3972,5349370,8244,4468775,12216,9818145
3004,2021-01-11,AR,235,425218,0,21,74877,0,0,2021-01-11,AR,13431,5137995,15725,3925960,29156,9063955
3005,2021-01-11,AR,235,425218,0,21,74877,0,0,2021-01-11,AR,2124,4332416,7629,3466938,9753,7799354
3006,2021-01-11,AR,235,425218,0,21,74877,0,0,2021-01-11,AR,3505,4130425,24193,2685734,27698,6816159
3007,2021-01-11,AR,235,425218,0,21,74877,0,0,2021-01-11,AR,12974,3837431,45385,1400879,58359,5238310
3008,2021-01-11,AR,235,425218,0,21,74877,0,0,2021-01-11,AR,21336,2899545,984,733675,22320,3633220
3009,2021-01-11,AR,235,425218,0,21,74877,0,0,2021-01-11,AR,46307,1889237,6081,470388,52388,2359625
3010,2021-01-11,AR,235,425218,0,21,74877,0,0,2021-01-11,AR,10716,1161597,9382,225983,20098,1387580
3011,2021-01-11,AR,235,425218,0,21,74877,0,0,2021-01-11,AR,6441,710509,182,106317,6623,816826
3012,2021-01-11,AR,235,425218,0,21,74877,0,0,2021-01-11,AR,21317,271463,4409,56363,25726,327826
3013,2021-01-11,AR,235,425218,0,21,74877,0,0,2021-01-11,AR,603,52477,1925,32493,2528,84970
3014,2021-01-11,AR,235,425218,0,21,74877,0,0,2021-01-11,AR,2644,21444,1,6,2645,21450
3015,2021-01-11,AR,175,431754,0,19,75737,0,0,2021-01-11,AR,3972,5349370,8244,4468775,12216,9818145
3016,2021-01-11,AR,175,431754,0,19,75737,0,0,2021-01-11,AR,13431,5137995,15725,3925960,29156,9063955
3017,2021-01-11,AR,175,431754,0,19,75737,0,0,2021-01-11,AR,2124,4332416,7629,3466938,9753,7799354
3018,2021-01-11,AR,175,431754,0,19,75737,0,0,2021-01-11,AR,3505,4130425,24193,2685734,27698,6816159
3019,2021-01-11,AR,175,431754,0,19,75737,0,0,2021-01-11,AR,12974,3837431,45385,1400879,58359,5238310
3020,2021-01-11,AR,175,431754,0,19,75737,0,0,2021-01-11,AR,21336,2899545,984,733675,22320,3633220
3021,2021-01-11,AR,175,431754,0,19,75737,0,0,2021-01-11,AR,46307,1889237,6081,470388,52388,2359625
3022,2021-01-11,AR,175,431754,0,19,75737,0,0,2021-01-11,AR,10716,1161597,9382,225983,20098,1387580
3023,2021-01-11,AR,175,431754,0,19,75737,0,0,2021-01-11,AR,6441,710509,182,106317,6623,816826
3024,2021-01-11,AR,175,431754,0,19,75737,0,0,2021-01-11,AR,21317,271463,4409,56363,25726,327826
3025,2021-01-11,AR,175,431754,0,19,75737,0,0,2021-01-11,AR,603,52477,1925,32493,2528,84970
3026,2021-01-11,AR,175,431754,0,19,75737,0,0,2021-01-11,AR,2644,21444,1,6,2645,21450
3027,2021-01-08,AR,622,238025,0,112,38115,0,0,2021-01-08,AR,3474,5330519,7454,4425508,10928,9756027
3028,2021-01-08,AR,622,238025,0,112,38115,0,0,2021-01-08,AR,15676,5089863,12264,3876309,27940,8966172
3029,2021-01-08,AR,622,238025,0,112,38115,0,0,2021-01-08,AR,4069,4327221,11994,3437006,16063,7764227
3030,2021-01-08,AR,622,238025,0,112,38115,0,0,2021-01-08,AR,8134,4113139,44761,2571726,52895,6684865
3031,2021-01-08,AR,622,238025,0,112,38115,0,0,2021-01-08,AR,4983,3793354,18516,1275129,23499,5068483
3032,2021-01-08,AR,622,238025,0,112,38115,0,0,2021-01-08,AR,50934,2802560,5650,714393,56584,3516953
3033,2021-01-08,AR,622,238025,0,112,38115,0,0,2021-01-08,AR,47043,1750318,4766,458702,51809,2209020
3034,2021-01-08,AR,622,238025,0,112,38115,0,0,2021-01-08,AR,4690,1137486,5752,206793,10442,1344279
3035,2021-01-08,AR,622,238025,0,112,38115,0,0,2021-01-08,AR,32880,659728,799,103638,33679,763366
3036,2021-01-08,AR,622,238025,0,112,38115,0,0,2021-01-08,AR,13904,211836,326,50760,14230,262596
3037,2021-01-08,AR,622,238025,0,112,38115,0,0,2021-01-08,AR,2262,48282,1043,29082,3305,77364
3038,2021-01-08,AR,622,238025,0,112,38115,0,0,2021-01-08,AR,3818,17208,2,5,3820,17213
3039,2021-01-08,AR,513,254531,0,89,41392,0,0,2021-01-08,AR,3474,5330519,7454,4425508,10928,9756027
3040,2021-01-08,AR,513,254531,0,89,41392,0,0,2021-01-08,AR,15676,5089863,12264,3876309,27940,8966172
3041,2021-01-08,AR,513,254531,0,89,41392,0,0,2021-01-08,AR,4069,4327221,11994,3437006,16063,7764227
3042,2021-01-08,AR,513,254531,0,89,41392,0,0,2021-01-08,AR,8134,4113139,44761,2571726,52895,6684865
3043,2021-01-08,AR,513,254531,0,89,41392,0,0,2021-01-08,AR,4983,3793354,18516,1275129,23499,5068483
3044,2021-01-08,AR,513,254531,0,89,41392,0,0,2021-01-08,AR,50934,2802560,5650,714393,56584,3516953
3045,2021-01-08,AR,513,254531,0,89,41392,0,0,2021-01-08,AR,47043,1750318,4766,458702,51809,2209020
3046,2021-01-08,AR,513,254531,0,89,41392,0,0,2021-01-08,AR,4690,1137486,5752,206793,10442,1344279
3047,2021-01-08,AR,513,254531,0,89,41392,0,0,2021-01-08,AR,32880,659728,799,103638,33679,763366
3048,2021-01-08,AR,513,254531,0,89,41392,0,0,2021-01-08,AR,13904,211836,326,50760,14230,262596
3049,2021-01-08,AR,513,254531,0,89,41392,0,0,2021-01-08,AR,2262,48282,1043,29082,3305,77364
3050,2021-01-08,AR,513,254531,0,89,41392,0,0,2021-01-08,AR,3818,17208,2,5,3820,17213
3051,2021-01-08,AR,495,266836,0,100,43706,0,0,2021-01-08,AR,3474,5330519,7454,4425508,10928,9756027
3052,2021-01-08,AR,495,266836,0,100,43706,0,0,2021-01-08,AR,15676,5089863,12264,3876309,27940,8966172
3053,2021-01-08,AR,495,266836,0,100,43706,0,0,2021-01-08,AR,4069,4327221,11994,3437006,16063,7764227
3054,2021-01-08,AR,495,266836,0,100,43706,0,0,2021-01-08,AR,8134,4113139,44761,2571726,52895,6684865
3055,2021-01-08,AR,495,266836,0,100,43706,0,0,2021-01-08,AR,4983,3793354,18516,1275129,23499,5068483
3056,2021-01-08,AR,495,266836,0,100,43706,0,0,2021-01-08,AR,50934,2802560,5650,714393,56584,3516953
3057,2021-01-08,AR,495,266836,0,100,43706,0,0,2021-01-08,AR,47043,1750318,4766,458702,51809,2209020
3058,2021-01-08,AR,495,266836,0,100,43706,0,0,2021-01-08,AR,4690,1137486,5752,206793,10442,1344279
3059,2021-01-08,AR,495,266836,0,100,43706,0,0,2021-01-08,AR,32880,659728,799,103638,33679,763366
3060,2021-01-08,AR,495,266836,0,100,43706,0,0,2021-01-08,AR,13904,211836,326,50760,14230,262596
3061,2021-01-08,AR,495,266836,0,100,43706,0,0,2021-01-08,AR,2262,48282,1043,29082,3305,77364
3062,2021-01-08,AR,495,266836,0,100,43706,0,0,2021-01-08,AR,3818,17208,2,5,3820,17213
3063,2021-01-08,AR,804,283825,0,166,47177,0,0,2021-01-08,AR,3474,5330519,7454,4425508,10928,9756027
3064,2021-01-08,AR,804,283825,0,166,47177,0,0,2021-01-08,AR,15676,5089863,12264,3876309,27940,8966172
3065,2021-01-08,AR,804,283825,0,166,47177,0,0,2021-01-08,AR,4069,4327221,11994,3437006,16063,7764227
3066,2021-01-08,AR,804,283825,0,166,47177,0,0,2021-01-08,AR,8134,4113139,44761,2571726,52895,6684865
3067,2021-01-08,AR,804,283825,0,166,47177,0,0,2021-01-08,AR,4983,3793354,18516,1275129,23499,5068483
3068,2021-01-08,AR,804,283825,0,166,47177,0,0,2021-01-08,AR,50934,2802560,5650,714393,56584,3516953
3069,2021-01-08,AR,804,283825,0,166,47177,0,0,2021-01-08,AR,47043,1750318,4766,458702,51809,2209020
3070,2021-01-08,AR,804,283825,0,166,47177,0,0,2021-01-08,AR,4690,1137486,5752,206793,10442,1344279
3071,2021-01-08,AR,804,283825,0,166,47177,0,0,2021-01-08,AR,32880,659728,799,103638,33679,763366
3072,2021-01-08,AR,804,283825,0,166,47177,0,0,2021-01-08,AR,13904,211836,326,50760,14230,262596
3073,2021-01-08,AR,804,283825,0,166,47177,0,0,2021-01-08,AR,2262,48282,1043,29082,3305,77364
3074,2021-01-08,AR,804,283825,0,166,47177,0,0,2021-01-08,AR,3818,17208,2,5,3820,17213
3075,2021-01-08,AR,834,310840,0,205,52984,0,0,2021-01-08,AR,3474,5330519,7454,4425508,10928,9756027
3076,2021-01-08,AR,834,310840,0,205,52984,0,0,2021-01-08,AR,15676,5089863,12264,3876309,27940,8966172
3077,2021-01-08,AR,834,310840,0,205,52984,0,0,2021-01-08,AR,4069,4327221,11994,3437006,16063,7764227
3078,2021-01-08,AR,834,310840,0,205,52984,0,0,2021-01-08,AR,8134,4113139,44761,2571726,52895,6684865
3079,2021-01-08,AR,834,310840,0,205,52984,0,0,2021-01-08,AR,4983,3793354,18516,1275129,23499,5068483
3080,2021-01-08,AR,834,310840,0,205,52984,0,0,2021-01-08,AR,50934,2802560,5650,714393,56584,3516953
3081,2021-01-08,AR,834,310840,0,205,52984,0,0,2021-01-08,AR,47043,1750318,4766,458702,51809,2209020
3082,2021-01-08,AR,834,310840,0,205,52984,0,0,2021-01-08,AR,4690,1137486,5752,206793,10442,1344279
3083,2021-01-08,AR,834,310840,0,205,52984,0,0,2021-01-08,AR,32880,659728,799,103638,33679,763366
3084,2021-01-08,AR,834,310840,0,205,52984,0,0,2021-01-08,AR,13904,211836,326,50760,14230,262596
3085,2021-01-08,AR,834,310840,0,205,52984,0,0,2021-01-08,AR,2262,48282,1043,29082,3305,77364
3086,2021-01-08,AR,834,310840,0,205,52984,0,0,2021-01-08,AR,3818,17208,2,5,3820,17213
3087,2021-01-08,AR,1170,345476,0,246,60637,0,0,2021-01-08,AR,3474,5330519,7454,4425508,10928,9756027
3088,2021-01-08,AR,1170,345476,0,246,60637,0,0,2021-01-08,AR,15676,5089863,12264,3876309,27940,8966172
3089,2021-01-08,AR,1170,345476,0,246,60637,0,0,2021-01-08,AR,4069,4327221,11994,3437006,16063,7764227
3090,2021-01-08,AR,1170,345476,0,246,60637,0,0,2021-01-08,AR,8134,4113139,44761,2571726,52895,6684865
3091,2021-01-08,AR,1170,345476,0,246,60637,0,0,2021-01-08,AR,4983,3793354,18516,1275129,23499,5068483
3092,2021-01-08,AR,1170,345476,0,246,60637,0,0,2021-01-08,AR,50934,2802560,5650,714393,56584,3516953
3093,2021-01-08,AR,1170,345476,0,246,60637,0,0,2021-01-08,AR,47043,1750318,4766,458702,51809,2209020
3094,2021-01-08,AR,1170,345476,0,246,60637,0,0,2021-01-08,AR,4690,1137486,5752,206793,10442,1344279
3095,2021-01-08,AR,1170,345476,0,246,60637,0,0,2021-01-08,AR,32880,659728,799,103638,33679,763366
3096,2021-01-08,AR,1170,345476,0,246,60637,0,0,2021-01-08,AR,13904,211836,326,50760,14230,262596
3097,2021-01-08,AR,1170,345476,0,246,60637,0,0,2021-01-08,AR,2262,48282,1043,29082,3305,77364
3098,2021-01-08,AR,1170,345476,0,246,60637,0,0,2021-01-08,AR,3818,17208,2,5,3820,17213
3099,2021-01-08,AR,817,372243,0,162,66376,0,0,2021-01-08,AR,3474,5330519,7454,4425508,10928,9756027
3100,2021-01-08,AR,817,372243,0,162,66376,0,0,2021-01-08,AR,15676,5089863,12264,3876309,27940,8966172
3101,2021-01-08,AR,817,372243,0,162,66376,0,0,2021-01-08,AR,4069,4327221,11994,3437006,16063,7764227
3102,2021-01-08,AR,817,372243,0,162,66376,0,0,2021-01-08,AR,8134,4113139,44761,2571726,52895,6684865
3103,2021-01-08,AR,817,372243,0,162,66376,0,0,2021-01-08,AR,4983,3793354,18516,1275129,23499,5068483
3104,2021-01-08,AR,817,372243,0,162,66376,0,0,2021-01-08,AR,50934,2802560,5650,714393,56584,3516953
3105,2021-01-08,AR,817,372243,0,162,66376,0,0,2021-01-08,AR,47043,1750318,4766,458702,51809,2209020
3106,2021-01-08,AR,817,372243,0,162,66376,0,0,2021-01-08,AR,4690,1137486,5752,206793,10442,1344279
3107,2021-01-08,AR,817,372243,0,162,66376,0,0,2021-01-08,AR,32880,659728,799,103638,33679,763366
3108,2021-01-08,AR,817,372243,0,162,66376,0,0,2021-01-08,AR,13904,211836,326,50760,14230,262596
3109,2021-01-08,AR,817,372243,0,162,66376,0,0,2021-01-08,AR,2262,48282,1043,29082,3305,77364
3110,2021-01-08,AR,817,372243,0,162,66376,0,0,2021-01-08,AR,3818,17208,2,5,3820,17213
3111,2021-01-08,AR,474,393178,0,105,70384,0,0,2021-01-08,AR,3474,5330519,7454,4425508,10928,9756027
3112,2021-01-08,AR,474,393178,0,105,70384,0,0,2021-01-08,AR,15676,5089863,12264,3876309,27940,8966172
3113,2021-01-08,AR,474,393178,0,105,70384,0,0,2021-01-08,AR,4069,4327221,11994,3437006,16063,7764227
3114,2021-01-08,AR,474,393178,0,105,70384,0,0,2021-01-08,AR,8134,4113139,44761,2571726,52895,6684865
3115,2021-01-08,AR,474,393178,0,105,70384,0,0,2021-01-08,AR,4983,3793354,18516,1275129,23499,5068483
3116,2021-01-08,AR,474,393178,0,105,70384,0,0,2021-01-08,AR,50934,2802560,5650,714393,56584,3516953
3117,2021-01-08,AR,474,393178,0,105,70384,0,0,2021-01-08,AR,47043,1750318,4766,458702,51809,2209020
3118,2021-01-08,AR,474,393178,0,105,70384,0,0,2021-01-08,AR,4690,1137486,5752,206793,10442,1344279
3119,2021-01-08,AR,474,393178,0,105,70384,0,0,2021-01-08,AR,32880,659728,799,103638,33679,763366
3120,2021-01-08,AR,474,393178,0,105,70384,0,0,2021-01-08,AR,13904,211836,326,50760,14230,262596
3121,2021-01-08,AR,474,393178,0,105,70384,0,0,2021-01-08,AR,2262,48282,1043,29082,3305,77364
3122,2021-01-08,AR,474,393178,0,105,70384,0,0,2021-01-08,AR,3818,17208,2,5,3820,17213
3123,2021-01-08,AR,410,407955,0,60,72788,0,0,2021-01-08,AR,3474,5330519,7454,4425508,10928,9756027
3124,2021-01-08,AR,410,407955,0,60,72788,0,0,2021-01-08,AR,15676,5089863,12264,3876309,27940,8966172
3125,2021-01-08,AR,410,407955,0,60,72788,0,0,2021-01-08,AR,4069,4327221,11994,3437006,16063,7764227
3126,2021-01-08,AR,410,407955,0,60,72788,0,0,2021-01-08,AR,8134,4113139,44761,2571726,52895,6684865
3127,2021-01-08,AR,410,407955,0,60,72788,0,0,2021-01-08,AR,4983,3793354,18516,1275129,23499,5068483
3128,2021-01-08,AR,410,407955,0,60,72788,0,0,2021-01-08,AR,50934,2802560,5650,714393,56584,3516953
3129,2021-01-08,AR,410,407955,0,60,72788,0,0,2021-01-08,AR,47043,1750318,4766,458702,51809,2209020
3130,2021-01-08,AR,410,407955,0,60,72788,0,0,2021-01-08,AR,4690,1137486,5752,206793,10442,1344279
3131,2021-01-08,AR,410,407955,0,60,72788,0,0,2021-01-08,AR,32880,659728,799,103638,33679,763366
3132,2021-01-08,AR,410,407955,0,60,72788,0,0,2021-01-08,AR,13904,211836,326,50760,14230,262596
3133,2021-01-08,AR,410,407955,0,60,72788,0,0,2021-01-08,AR,2262,48282,1043,29082,3305,77364
3134,2021-01-08,AR,410,407955,0,60,72788,0,0,2021-01-08,AR,3818,17208,2,5,3820,17213
3135,2021-01-08,AR,201,416852,0,28,73889,0,0,2021-01-08,AR,3474,5330519,7454,4425508,10928,9756027
3136,2021-01-08,AR,201,416852,0,28,73889,0,0,2021-01-08,AR,15676,5089863,12264,3876309,27940,8966172
3137,2021-01-08,AR,201,416852,0,28,73889,0,0,2021-01-08,AR,4069,4327221,11994,3437006,16063,7764227
3138,2021-01-08,AR,201,416852,0,28,73889,0,0,2021-01-08,AR,8134,4113139,44761,2571726,52895,6684865
3139,2021-01-08,AR,201,416852,0,28,73889,0,0,2021-01-08,AR,4983,3793354,18516,1275129,23499,5068483
3140,2021-01-08,AR,201,416852,0,28,73889,0,0,2021-01-08,AR,50934,2802560,5650,714393,56584,3516953
3141,2021-01-08,AR,201,416852,0,28,73889,0,0,2021-01-08,AR,47043,1750318,4766,458702,51809,2209020
3142,2021-01-08,AR,201,416852,0,28,73889,0,0,2021-01-08,AR,4690,1137486,5752,206793,10442,1344279
3143,2021-01-08,AR,201,416852,0,28,73889,0,0,2021-01-08,AR,32880,659728,799,103638,33679,763366
3144,2021-01-08,AR,201,416852,0,28,73889,0,0,2021-01-08,AR,13904,211836,326,50760,14230,262596
3145,2021-01-08,AR,201,416852,0,28,73889,0,0,2021-01-08,AR,2262,48282,1043,29082,3305,77364
3146,2021-01-08,AR,201,416852,0,28,73889,0,0,2021-01-08,AR,3818,17208,2,5,3820,17213
3147,2021-01-08,AR,281,424464,0,33,74789,0,0,2021-01-08,AR,3474,5330519,7454,4425508,10928,9756027
3148,2021-01-08,AR,281,424464,0,33,74789,0,0,2021-01-08,AR,15676,5089863,12264,3876309,27940,8966172
3149,2021-01-08,AR,281,424464,0,33,74789,0,0,2021-01-08,AR,4069,4327221,11994,3437006,16063,7764227
3150,2021-01-08,AR,281,424464,0,33,74789,0,0,2021-01-08,AR,8134,4113139,44761,2571726,52895,6684865
3151,2021-01-08,AR,281,424464,0,33,74789,0,0,2021-01-08,AR,4983,3793354,18516,1275129,23499,5068483
3152,2021-01-08,AR,281,424464,0,33,74789,0,0,2021-01-08,AR,50934,2802560,5650,714393,56584,3516953
3153,2021-01-08,AR,281,424464,0,33,74789,0,0,2021-01-08,AR,47043,1750318,4766,458702,51809,2209020
3154,2021-01-08,AR,281,424464,0,33,74789,0,0,2021-01-08,AR,4690,1137486,5752,206793,10442,1344279
3155,2021-01-08,AR,281,424464,0,33,74789,0,0,2021-01-08,AR,32880,659728,799,103638,33679,763366
3156,2021-01-08,AR,281,424464,0,33,74789,0,0,2021-01-08,AR,13904,211836,326,50760,14230,262596
3157,2021-01-08,AR,281,424464,0,33,74789,0,0,2021-01-08,AR,2262,48282,1043,29082,3305,77364
3158,2021-01-08,AR,281,424464,0,33,74789,0,0,2021-01-08,AR,3818,17208,2,5,3820,17213
3159,2021-01-08,AR,206,431126,0,30,75678,0,0,2021-01-08,AR,3474,5330519,7454,4425508,10928,9756027
3160,2021-01-08,AR,206,431126,0,30,75678,0,0,2021-01-08,AR,15676,5089863,12264,3876309,27940,8966172
3161,2021-01-08,AR,206,431126,0,30,75678,0,0,2021-01-08,AR,4069,4327221,11994,3437006,16063,7764227
3162,2021-01-08,AR,206,431126,0,30,75678,0,0,2021-01-08,AR,8134,4113139,44761,2571726,52895,6684865
3163,2021-01-08,AR,206,431126,0,30,75678,0,0,2021-01-08,AR,4983,3793354,18516,1275129,23499,5068483
3164,2021-01-08,AR,206,431126,0,30,75678,0,0,2021-01-08,AR,50934,2802560,5650,714393,56584,3516953
3165,2021-01-08,AR,206,431126,0,30,75678,0,0,2021-01-08,AR,47043,1750318,4766,458702,51809,2209020
3166,2021-01-08,AR,206,431126,0,30,75678,0,0,2021-01-08,AR,4690,1137486,5752,206793,10442,1344279
3167,2021-01-08,AR,206,431126,0,30,75678,0,0,2021-01-08,AR,32880,659728,799,103638,33679,763366
3168,2021-01-08,AR,206,431126,0,30,75678,0,0,2021-01-08,AR,13904,211836,326,50760,14230,262596
3169,2021-01-08,AR,206,431126,0,30,75678,0,0,2021-01-08,AR,2262,48282,1043,29082,3305,77364
3170,2021-01-08,AR,206,431126,0,30,75678,0,0,2021-01-08,AR,3818,17208,2,5,3820,17213
3171,2021-01-02,AR,575,234161,0,105,37468,0,0,2021-01-02,AR,10730,5291964,22520,4340109,33250,9632073
3172,2021-01-02,AR,575,234161,0,105,37468,0,0,2021-01-02,AR,18701,4991605,20771,3785447,39472,8777052
3173,2021-01-02,AR,575,234161,0,105,37468,0,0,2021-01-02,AR,3938,4275104,23379,3315079,27317,7590183
3174,2021-01-02,AR,575,234161,0,105,37468,0,0,2021-01-02,AR,11108,4072823,51732,2295964,62840,6368787
3175,2021-01-02,AR,575,234161,0,105,37468,0,0,2021-01-02,AR,25296,3681724,34579,1083499,59875,4765223
3176,2021-01-02,AR,575,234161,0,105,37468,0,0,2021-01-02,AR,49047,2581736,11998,634479,61045,3216215
3177,2021-01-02,AR,575,234161,0,105,37468,0,0,2021-01-02,AR,35964,1489738,7291,431754,43255,1921492
3178,2021-01-02,AR,575,234161,0,105,37468,0,0,2021-01-02,AR,3440,1043134,1787,143309,5227,1186443
3179,2021-01-02,AR,575,234161,0,105,37468,0,0,2021-01-02,AR,9408,528039,110,99035,9518,627074
3180,2021-01-02,AR,575,234161,0,105,37468,0,0,2021-01-02,AR,9465,152502,1013,45054,10478,197556
3181,2021-01-02,AR,575,234161,0,105,37468,0,0,2021-01-02,AR,711,40684,2591,19198,3302,59882
3182,2021-01-02,AR,575,234161,0,105,37468,0,0,2021-01-02,AR,410,6425,0,0,410,6425
3183,2021-01-12,AR,626,240380,0,124,38547,0,0,2021-01-12,AR,1812,5351182,4839,4473614,6651,9824796
3184,2021-01-12,AR,626,240380,0,124,38547,0,0,2021-01-12,AR,11860,5149855,21444,3947404,33304,9097259
3185,2021-01-12,AR,626,240380,0,124,38547,0,0,2021-01-12,AR,29072,4361488,16975,3483913,46047,7845401
3186,2021-01-12,AR,626,240380,0,124,38547,0,0,2021-01-12,AR,298,4130723,872,2686606,1170,6817329
3187,2021-01-12,AR,626,240380,0,124,38547,0,0,2021-01-12,AR,11130,3848561,44884,1445763,56014,5294324
3188,2021-01-12,AR,626,240380,0,124,38547,0,0,2021-01-12,AR,49224,2948769,4017,737692,53241,3686461
3189,2021-01-12,AR,626,240380,0,124,38547,0,0,2021-01-12,AR,15450,1904687,12210,482598,27660,2387285
3190,2021-01-12,AR,626,240380,0,124,38547,0,0,2021-01-12,AR,7309,1168906,20708,246691,28017,1415597
3191,2021-01-12,AR,626,240380,0,124,38547,0,0,2021-01-12,AR,24427,734936,1252,107569,25679,842505
3192,2021-01-12,AR,626,240380,0,124,38547,0,0,2021-01-12,AR,15936,287399,5859,62222,21795,349621
3193,2021-01-12,AR,626,240380,0,124,38547,0,0,2021-01-12,AR,593,53070,1646,34139,2239,87209
3194,2021-01-12,AR,626,240380,0,124,38547,0,0,2021-01-12,AR,2621,24065,0,6,2621,24071
3195,2021-01-02,AR,519,251664,0,112,40805,0,0,2021-01-02,AR,10730,5291964,22520,4340109,33250,9632073
3196,2021-01-02,AR,519,251664,0,112,40805,0,0,2021-01-02,AR,18701,4991605,20771,3785447,39472,8777052
3197,2021-01-02,AR,519,251664,0,112,40805,0,0,2021-01-02,AR,3938,4275104,23379,3315079,27317,7590183
3198,2021-01-02,AR,519,251664,0,112,40805,0,0,2021-01-02,AR,11108,4072823,51732,2295964,62840,6368787
3199,2021-01-02,AR,519,251664,0,112,40805,0,0,2021-01-02,AR,25296,3681724,34579,1083499,59875,4765223
3200,2021-01-02,AR,519,251664,0,112,40805,0,0,2021-01-02,AR,49047,2581736,11998,634479,61045,3216215
3201,2021-01-02,AR,519,251664,0,112,40805,0,0,2021-01-02,AR,35964,1489738,7291,431754,43255,1921492
3202,2021-01-02,AR,519,251664,0,112,40805,0,0,2021-01-02,AR,3440,1043134,1787,143309,5227,1186443
3203,2021-01-02,AR,519,251664,0,112,40805,0,0,2021-01-02,AR,9408,528039,110,99035,9518,627074
3204,2021-01-02,AR,519,251664,0,112,40805,0,0,2021-01-02,AR,9465,152502,1013,45054,10478,197556
3205,2021-01-02,AR,519,251664,0,112,40805,0,0,2021-01-02,AR,711,40684,2591,19198,3302,59882
3206,2021-01-02,AR,519,251664,0,112,40805,0,0,2021-01-02,AR,410,6425,0,0,410,6425
3207,2021-01-12,AR,499,256472,0,82,41748,0,0,2021-01-12,AR,1812,5351182,4839,4473614,6651,9824796
3208,2021-01-12,AR,499,256472,0,82,41748,0,0,2021-01-12,AR,11860,5149855,21444,3947404,33304,9097259
3209,2021-01-12,AR,499,256472,0,82,41748,0,0,2021-01-12,AR,29072,4361488,16975,3483913,46047,7845401
3210,2021-01-12,AR,499,256472,0,82,41748,0,0,2021-01-12,AR,298,4130723,872,2686606,1170,6817329
3211,2021-01-12,AR,499,256472,0,82,41748,0,0,2021-01-12,AR,11130,3848561,44884,1445763,56014,5294324
3212,2021-01-12,AR,499,256472,0,82,41748,0,0,2021-01-12,AR,49224,2948769,4017,737692,53241,3686461
3213,2021-01-12,AR,499,256472,0,82,41748,0,0,2021-01-12,AR,15450,1904687,12210,482598,27660,2387285
3214,2021-01-12,AR,499,256472,0,82,41748,0,0,2021-01-12,AR,7309,1168906,20708,246691,28017,1415597
3215,2021-01-12,AR,499,256472,0,82,41748,0,0,2021-01-12,AR,24427,734936,1252,107569,25679,842505
3216,2021-01-12,AR,499,256472,0,82,41748,0,0,2021-01-12,AR,15936,287399,5859,62222,21795,349621
3217,2021-01-12,AR,499,256472,0,82,41748,0,0,2021-01-12,AR,593,53070,1646,34139,2239,87209
3218,2021-01-12,AR,499,256472,0,82,41748,0,0,2021-01-12,AR,2621,24065,0,6,2621,24071
3219,2021-01-02,AR,495,264238,0,65,43203,0,0,2021-01-02,AR,10730,5291964,22520,4340109,33250,9632073
3220,2021-01-02,AR,495,264238,0,65,43203,0,0,2021-01-02,AR,18701,4991605,20771,3785447,39472,8777052
3221,2021-01-02,AR,495,264238,0,65,43203,0,0,2021-01-02,AR,3938,4275104,23379,3315079,27317,7590183
3222,2021-01-02,AR,495,264238,0,65,43203,0,0,2021-01-02,AR,11108,4072823,51732,2295964,62840,6368787
3223,2021-01-02,AR,495,264238,0,65,43203,0,0,2021-01-02,AR,25296,3681724,34579,1083499,59875,4765223
3224,2021-01-02,AR,495,264238,0,65,43203,0,0,2021-01-02,AR,49047,2581736,11998,634479,61045,3216215
3225,2021-01-02,AR,495,264238,0,65,43203,0,0,2021-01-02,AR,35964,1489738,7291,431754,43255,1921492
3226,2021-01-02,AR,495,264238,0,65,43203,0,0,2021-01-02,AR,3440,1043134,1787,143309,5227,1186443
3227,2021-01-02,AR,495,264238,0,65,43203,0,0,2021-01-02,AR,9408,528039,110,99035,9518,627074
3228,2021-01-02,AR,495,264238,0,65,43203,0,0,2021-01-02,AR,9465,152502,1013,45054,10478,197556
3229,2021-01-02,AR,495,264238,0,65,43203,0,0,2021-01-02,AR,711,40684,2591,19198,3302,59882
3230,2021-01-02,AR,495,264238,0,65,43203,0,0,2021-01-02,AR,410,6425,0,0,410,6425
3231,2021-01-12,AR,479,268788,0,102,44088,0,0,2021-01-12,AR,1812,5351182,4839,4473614,6651,9824796
3232,2021-01-12,AR,479,268788,0,102,44088,0,0,2021-01-12,AR,11860,5149855,21444,3947404,33304,9097259
3233,2021-01-12,AR,479,268788,0,102,44088,0,0,2021-01-12,AR,29072,4361488,16975,3483913,46047,7845401
3234,2021-01-12,AR,479,268788,0,102,44088,0,0,2021-01-12,AR,298,4130723,872,2686606,1170,6817329
3235,2021-01-12,AR,479,268788,0,102,44088,0,0,2021-01-12,AR,11130,3848561,44884,1445763,56014,5294324
3236,2021-01-12,AR,479,268788,0,102,44088,0,0,2021-01-12,AR,49224,2948769,4017,737692,53241,3686461
3237,2021-01-12,AR,479,268788,0,102,44088,0,0,2021-01-12,AR,15450,1904687,12210,482598,27660,2387285
3238,2021-01-12,AR,479,268788,0,102,44088,0,0,2021-01-12,AR,7309,1168906,20708,246691,28017,1415597
3239,2021-01-12,AR,479,268788,0,102,44088,0,0,2021-01-12,AR,24427,734936,1252,107569,25679,842505
3240,2021-01-12,AR,479,268788,0,102,44088,0,0,2021-01-12,AR,15936,287399,5859,62222,21795,349621
3241,2021-01-12,AR,479,268788,0,102,44088,0,0,2021-01-12,AR,593,53070,1646,34139,2239,87209
3242,2021-01-12,AR,479,268788,0,102,44088,0,0,2021-01-12,AR,2621,24065,0,6,2621,24071
3243,2021-01-02,AR,488,279486,0,123,46288,0,0,2021-01-02,AR,10730,5291964,22520,4340109,33250,9632073
3244,2021-01-02,AR,488,279486,0,123,46288,0,0,2021-01-02,AR,18701,4991605,20771,3785447,39472,8777052
3245,2021-01-02,AR,488,279486,0,123,46288,0,0,2021-01-02,AR,3938,4275104,23379,3315079,27317,7590183
3246,2021-01-02,AR,488,279486,0,123,46288,0,0,2021-01-02,AR,11108,4072823,51732,2295964,62840,6368787
3247,2021-01-02,AR,488,279486,0,123,46288,0,0,2021-01-02,AR,25296,3681724,34579,1083499,59875,4765223
3248,2021-01-02,AR,488,279486,0,123,46288,0,0,2021-01-02,AR,49047,2581736,11998,634479,61045,3216215
3249,2021-01-02,AR,488,279486,0,123,46288,0,0,2021-01-02,AR,35964,1489738,7291,431754,43255,1921492
3250,2021-01-02,AR,488,279486,0,123,46288,0,0,2021-01-02,AR,3440,1043134,1787,143309,5227,1186443
3251,2021-01-02,AR,488,279486,0,123,46288,0,0,2021-01-02,AR,9408,528039,110,99035,9518,627074
3252,2021-01-02,AR,488,279486,0,123,46288,0,0,2021-01-02,AR,9465,152502,1013,45054,10478,197556
3253,2021-01-02,AR,488,279486,0,123,46288,0,0,2021-01-02,AR,711,40684,2591,19198,3302,59882
3254,2021-01-02,AR,488,279486,0,123,46288,0,0,2021-01-02,AR,410,6425,0,0,410,6425
3255,2021-01-12,AR,919,286929,0,194,47817,0,0,2021-01-12,AR,1812,5351182,4839,4473614,6651,9824796
3256,2021-01-12,AR,919,286929,0,194,47817,0,0,2021-01-12,AR,11860,5149855,21444,3947404,33304,9097259
3257,2021-01-12,AR,919,286929,0,194,47817,0,0,2021-01-12,AR,29072,4361488,16975,3483913,46047,7845401
3258,2021-01-12,AR,919,286929,0,194,47817,0,0,2021-01-12,AR,298,4130723,872,2686606,1170,6817329
3259,2021-01-12,AR,919,286929,0,194,47817,0,0,2021-01-12,AR,11130,3848561,44884,1445763,56014,5294324
3260,2021-01-12,AR,919,286929,0,194,47817,0,0,2021-01-12,AR,49224,2948769,4017,737692,53241,3686461
3261,2021-01-12,AR,919,286929,0,194,47817,0,0,2021-01-12,AR,15450,1904687,12210,482598,27660,2387285
3262,2021-01-12,AR,919,286929,0,194,47817,0,0,2021-01-12,AR,7309,1168906,20708,246691,28017,1415597
3263,2021-01-12,AR,919,286929,0,194,47817,0,0,2021-01-12,AR,24427,734936,1252,107569,25679,842505
3264,2021-01-12,AR,919,286929,0,194,47817,0,0,2021-01-12,AR,15936,287399,5859,62222,21795,349621
3265,2021-01-12,AR,919,286929,0,194,47817,0,0,2021-01-12,AR,593,53070,1646,34139,2239,87209
3266,2021-01-12,AR,919,286929,0,194,47817,0,0,2021-01-12,AR,2621,24065,0,6,2621,24071
3267,2021-01-02,AR,803,305328,0,188,51732,0,0,2021-01-02,AR,10730,5291964,22520,4340109,33250,9632073
3268,2021-01-02,AR,803,305328,0,188,51732,0,0,2021-01-02,AR,18701,4991605,20771,3785447,39472,8777052
3269,2021-01-02,AR,803,305328,0,188,51732,0,0,2021-01-02,AR,3938,4275104,23379,3315079,27317,7590183
3270,2021-01-02,AR,803,305328,0,188,51732,0,0,2021-01-02,AR,11108,4072823,51732,2295964,62840,6368787
3271,2021-01-02,AR,803,305328,0,188,51732,0,0,2021-01-02,AR,25296,3681724,34579,1083499,59875,4765223
3272,2021-01-02,AR,803,305328,0,188,51732,0,0,2021-01-02,AR,49047,2581736,11998,634479,61045,3216215
3273,2021-01-02,AR,803,305328,0,188,51732,0,0,2021-01-02,AR,35964,1489738,7291,431754,43255,1921492
3274,2021-01-02,AR,803,305328,0,188,51732,0,0,2021-01-02,AR,3440,1043134,1787,143309,5227,1186443
3275,2021-01-02,AR,803,305328,0,188,51732,0,0,2021-01-02,AR,9408,528039,110,99035,9518,627074
3276,2021-01-02,AR,803,305328,0,188,51732,0,0,2021-01-02,AR,9465,152502,1013,45054,10478,197556
3277,2021-01-02,AR,803,305328,0,188,51732,0,0,2021-01-02,AR,711,40684,2591,19198,3302,59882
3278,2021-01-02,AR,803,305328,0,188,51732,0,0,2021-01-02,AR,410,6425,0,0,410,6425
3279,2021-01-12,AR,1075,314749,0,229,53848,0,0,2021-01-12,AR,1812,5351182,4839,4473614,6651,9824796
3280,2021-01-12,AR,1075,314749,0,229,53848,0,0,2021-01-12,AR,11860,5149855,21444,3947404,33304,9097259
3281,2021-01-12,AR,1075,314749,0,229,53848,0,0,2021-01-12,AR,29072,4361488,16975,3483913,46047,7845401
3282,2021-01-12,AR,1075,314749,0,229,53848,0,0,2021-01-12,AR,298,4130723,872,2686606,1170,6817329
3283,2021-01-12,AR,1075,314749,0,229,53848,0,0,2021-01-12,AR,11130,3848561,44884,1445763,56014,5294324
3284,2021-01-12,AR,1075,314749,0,229,53848,0,0,2021-01-12,AR,49224,2948769,4017,737692,53241,3686461
3285,2021-01-12,AR,1075,314749,0,229,53848,0,0,2021-01-12,AR,15450,1904687,12210,482598,27660,2387285
3286,2021-01-12,AR,1075,314749,0,229,53848,0,0,2021-01-12,AR,7309,1168906,20708,246691,28017,1415597
3287,2021-01-12,AR,1075,314749,0,229,53848,0,0,2021-01-12,AR,24427,734936,1252,107569,25679,842505
3288,2021-01-12,AR,1075,314749,0,229,53848,0,0,2021-01-12,AR,15936,287399,5859,62222,21795,349621
3289,2021-01-12,AR,1075,314749,0,229,53848,0,0,2021-01-12,AR,593,53070,1646,34139,2239,87209
3290,2021-01-12,AR,1075,314749,0,229,53848,0,0,2021-01-12,AR,2621,24065,0,6,2621,24071
3291,2021-01-02,AR,1257,338692,0,281,59138,0,0,2021-01-02,AR,10730,5291964,22520,4340109,33250,9632073
3292,2021-01-02,AR,1257,338692,0,281,59138,0,0,2021-01-02,AR,18701,4991605,20771,3785447,39472,8777052
3293,2021-01-02,AR,1257,338692,0,281,59138,0,0,2021-01-02,AR,3938,4275104,23379,3315079,27317,7590183
3294,2021-01-02,AR,1257,338692,0,281,59138,0,0,2021-01-02,AR,11108,4072823,51732,2295964,62840,6368787
3295,2021-01-02,AR,1257,338692,0,281,59138,0,0,2021-01-02,AR,25296,3681724,34579,1083499,59875,4765223
3296,2021-01-02,AR,1257,338692,0,281,59138,0,0,2021-01-02,AR,49047,2581736,11998,634479,61045,3216215
3297,2021-01-02,AR,1257,338692,0,281,59138,0,0,2021-01-02,AR,35964,1489738,7291,431754,43255,1921492
3298,2021-01-02,AR,1257,338692,0,281,59138,0,0,2021-01-02,AR,3440,1043134,1787,143309,5227,1186443
3299,2021-01-02,AR,1257,338692,0,281,59138,0,0,2021-01-02,AR,9408,528039,110,99035,9518,627074
3300,2021-01-02,AR,1257,338692,0,281,59138,0,0,2021-01-02,AR,9465,152502,1013,45054,10478,197556
3301,2021-01-02,AR,1257,338692,0,281,59138,0,0,2021-01-02,AR,711,40684,2591,19198,3302,59882
3302,2021-01-02,AR,1257,338692,0,281,59138,0,0,2021-01-02,AR,410,6425,0,0,410,6425
3303,2021-01-12,AR,925,349728,0,223,61598,0,0,2021-01-12,AR,1812,5351182,4839,4473614,6651,9824796
3304,2021-01-12,AR,925,349728,0,223,61598,0,0,2021-01-12,AR,11860,5149855,21444,3947404,33304,9097259
3305,2021-01-12,AR,925,349728,0,223,61598,0,0,2021-01-12,AR,29072,4361488,16975,3483913,46047,7845401
3306,2021-01-12,AR,925,349728,0,223,61598,0,0,2021-01-12,AR,298,4130723,872,2686606,1170,6817329
3307,2021-01-12,AR,925,349728,0,223,61598,0,0,2021-01-12,AR,11130,3848561,44884,1445763,56014,5294324
3308,2021-01-12,AR,925,349728,0,223,61598,0,0,2021-01-12,AR,49224,2948769,4017,737692,53241,3686461
3309,2021-01-12,AR,925,349728,0,223,61598,0,0,2021-01-12,AR,15450,1904687,12210,482598,27660,2387285
3310,2021-01-12,AR,925,349728,0,223,61598,0,0,2021-01-12,AR,7309,1168906,20708,246691,28017,1415597
3311,2021-01-12,AR,925,349728,0,223,61598,0,0,2021-01-12,AR,24427,734936,1252,107569,25679,842505
3312,2021-01-12,AR,925,349728,0,223,61598,0,0,2021-01-12,AR,15936,287399,5859,62222,21795,349621
3313,2021-01-12,AR,925,349728,0,223,61598,0,0,2021-01-12,AR,593,53070,1646,34139,2239,87209
3314,2021-01-12,AR,925,349728,0,223,61598,0,0,2021-01-12,AR,2621,24065,0,6,2621,24071
3315,2021-01-02,AR,858,367329,0,162,65383,0,0,2021-01-02,AR,10730,5291964,22520,4340109,33250,9632073
3316,2021-01-02,AR,858,367329,0,162,65383,0,0,2021-01-02,AR,18701,4991605,20771,3785447,39472,8777052
3317,2021-01-02,AR,858,367329,0,162,65383,0,0,2021-01-02,AR,3938,4275104,23379,3315079,27317,7590183
3318,2021-01-02,AR,858,367329,0,162,65383,0,0,2021-01-02,AR,11108,4072823,51732,2295964,62840,6368787
3319,2021-01-02,AR,858,367329,0,162,65383,0,0,2021-01-02,AR,25296,3681724,34579,1083499,59875,4765223
3320,2021-01-02,AR,858,367329,0,162,65383,0,0,2021-01-02,AR,49047,2581736,11998,634479,61045,3216215
3321,2021-01-02,AR,858,367329,0,162,65383,0,0,2021-01-02,AR,35964,1489738,7291,431754,43255,1921492
3322,2021-01-02,AR,858,367329,0,162,65383,0,0,2021-01-02,AR,3440,1043134,1787,143309,5227,1186443
3323,2021-01-02,AR,858,367329,0,162,65383,0,0,2021-01-02,AR,9408,528039,110,99035,9518,627074
3324,2021-01-02,AR,858,367329,0,162,65383,0,0,2021-01-02,AR,9465,152502,1013,45054,10478,197556
3325,2021-01-02,AR,858,367329,0,162,65383,0,0,2021-01-02,AR,711,40684,2591,19198,3302,59882
3326,2021-01-02,AR,858,367329,0,162,65383,0,0,2021-01-02,AR,410,6425,0,0,410,6425
3327,2021-01-12,AR,967,375277,0,180,66966,0,0,2021-01-12,AR,1812,5351182,4839,4473614,6651,9824796
3328,2021-01-12,AR,967,375277,0,180,66966,0,0,2021-01-12,AR,11860,5149855,21444,3947404,33304,9097259
3329,2021-01-12,AR,967,375277,0,180,66966,0,0,2021-01-12,AR,29072,4361488,16975,3483913,46047,7845401
3330,2021-01-12,AR,967,375277,0,180,66966,0,0,2021-01-12,AR,298,4130723,872,2686606,1170,6817329
3331,2021-01-12,AR,967,375277,0,180,66966,0,0,2021-01-12,AR,11130,3848561,44884,1445763,56014,5294324
3332,2021-01-12,AR,967,375277,0,180,66966,0,0,2021-01-12,AR,49224,2948769,4017,737692,53241,3686461
3333,2021-01-12,AR,967,375277,0,180,66966,0,0,2021-01-12,AR,15450,1904687,12210,482598,27660,2387285
3334,2021-01-12,AR,967,375277,0,180,66966,0,0,2021-01-12,AR,7309,1168906,20708,246691,28017,1415597
3335,2021-01-12,AR,967,375277,0,180,66966,0,0,2021-01-12,AR,24427,734936,1252,107569,25679,842505
3336,2021-01-12,AR,967,375277,0,180,66966,0,0,2021-01-12,AR,15936,287399,5859,62222,21795,349621
3337,2021-01-12,AR,967,375277,0,180,66966,0,0,2021-01-12,AR,593,53070,1646,34139,2239,87209
3338,2021-01-12,AR,967,375277,0,180,66966,0,0,2021-01-12,AR,2621,24065,0,6,2621,24071
3339,2021-01-02,AR,778,389564,0,126,69691,0,0,2021-01-02,AR,10730,5291964,22520,4340109,33250,9632073
3340,2021-01-02,AR,778,389564,0,126,69691,0,0,2021-01-02,AR,18701,4991605,20771,3785447,39472,8777052
3341,2021-01-02,AR,778,389564,0,126,69691,0,0,2021-01-02,AR,3938,4275104,23379,3315079,27317,7590183
3342,2021-01-02,AR,778,389564,0,126,69691,0,0,2021-01-02,AR,11108,4072823,51732,2295964,62840,6368787
3343,2021-01-02,AR,778,389564,0,126,69691,0,0,2021-01-02,AR,25296,3681724,34579,1083499,59875,4765223
3344,2021-01-02,AR,778,389564,0,126,69691,0,0,2021-01-02,AR,49047,2581736,11998,634479,61045,3216215
3345,2021-01-02,AR,778,389564,0,126,69691,0,0,2021-01-02,AR,35964,1489738,7291,431754,43255,1921492
3346,2021-01-02,AR,778,389564,0,126,69691,0,0,2021-01-02,AR,3440,1043134,1787,143309,5227,1186443
3347,2021-01-02,AR,778,389564,0,126,69691,0,0,2021-01-02,AR,9408,528039,110,99035,9518,627074
3348,2021-01-02,AR,778,389564,0,126,69691,0,0,2021-01-02,AR,9465,152502,1013,45054,10478,197556
3349,2021-01-02,AR,778,389564,0,126,69691,0,0,2021-01-02,AR,711,40684,2591,19198,3302,59882
3350,2021-01-02,AR,778,389564,0,126,69691,0,0,2021-01-02,AR,410,6425,0,0,410,6425
3351,2021-01-12,AR,565,395587,0,104,70803,0,0,2021-01-12,AR,1812,5351182,4839,4473614,6651,9824796
3352,2021-01-12,AR,565,395587,0,104,70803,0,0,2021-01-12,AR,11860,5149855,21444,3947404,33304,9097259
3353,2021-01-12,AR,565,395587,0,104,70803,0,0,2021-01-12,AR,29072,4361488,16975,3483913,46047,7845401
3354,2021-01-12,AR,565,395587,0,104,70803,0,0,2021-01-12,AR,298,4130723,872,2686606,1170,6817329
3355,2021-01-12,AR,565,395587,0,104,70803,0,0,2021-01-12,AR,11130,3848561,44884,1445763,56014,5294324
3356,2021-01-12,AR,565,395587,0,104,70803,0,0,2021-01-12,AR,49224,2948769,4017,737692,53241,3686461
3357,2021-01-12,AR,565,395587,0,104,70803,0,0,2021-01-12,AR,15450,1904687,12210,482598,27660,2387285
3358,2021-01-12,AR,565,395587,0,104,70803,0,0,2021-01-12,AR,7309,1168906,20708,246691,28017,1415597
3359,2021-01-12,AR,565,395587,0,104,70803,0,0,2021-01-12,AR,24427,734936,1252,107569,25679,842505
3360,2021-01-12,AR,565,395587,0,104,70803,0,0,2021-01-12,AR,15936,287399,5859,62222,21795,349621
3361,2021-01-12,AR,565,395587,0,104,70803,0,0,2021-01-12,AR,593,53070,1646,34139,2239,87209
3362,2021-01-12,AR,565,395587,0,104,70803,0,0,2021-01-12,AR,2621,24065,0,6,2621,24071
3363,2021-01-02,AR,420,405733,0,63,72447,0,0,2021-01-02,AR,10730,5291964,22520,4340109,33250,9632073
3364,2021-01-02,AR,420,405733,0,63,72447,0,0,2021-01-02,AR,18701,4991605,20771,3785447,39472,8777052
3365,2021-01-02,AR,420,405733,0,63,72447,0,0,2021-01-02,AR,3938,4275104,23379,3315079,27317,7590183
3366,2021-01-02,AR,420,405733,0,63,72447,0,0,2021-01-02,AR,11108,4072823,51732,2295964,62840,6368787
3367,2021-01-02,AR,420,405733,0,63,72447,0,0,2021-01-02,AR,25296,3681724,34579,1083499,59875,4765223
3368,2021-01-02,AR,420,405733,0,63,72447,0,0,2021-01-02,AR,49047,2581736,11998,634479,61045,3216215
3369,2021-01-02,AR,420,405733,0,63,72447,0,0,2021-01-02,AR,35964,1489738,7291,431754,43255,1921492
3370,2021-01-02,AR,420,405733,0,63,72447,0,0,2021-01-02,AR,3440,1043134,1787,143309,5227,1186443
3371,2021-01-02,AR,420,405733,0,63,72447,0,0,2021-01-02,AR,9408,528039,110,99035,9518,627074
3372,2021-01-02,AR,420,405733,0,63,72447,0,0,2021-01-02,AR,9465,152502,1013,45054,10478,197556
3373,2021-01-02,AR,420,405733,0,63,72447,0,0,2021-01-02,AR,711,40684,2591,19198,3302,59882
3374,2021-01-02,AR,420,405733,0,63,72447,0,0,2021-01-02,AR,410,6425,0,0,410,6425
3375,2021-01-12,AR,256,409226,0,32,72970,0,0,2021-01-12,AR,1812,5351182,4839,4473614,6651,9824796
3376,2021-01-12,AR,256,409226,0,32,72970,0,0,2021-01-12,AR,11860,5149855,21444,3947404,33304,9097259
3377,2021-01-12,AR,256,409226,0,32,72970,0,0,2021-01-12,AR,29072,4361488,16975,3483913,46047,7845401
3378,2021-01-12,AR,256,409226,0,32,72970,0,0,2021-01-12,AR,298,4130723,872,2686606,1170,6817329
3379,2021-01-12,AR,256,409226,0,32,72970,0,0,2021-01-12,AR,11130,3848561,44884,1445763,56014,5294324
3380,2021-01-12,AR,256,409226,0,32,72970,0,0,2021-01-12,AR,49224,2948769,4017,737692,53241,3686461
3381,2021-01-12,AR,256,409226,0,32,72970,0,0,2021-01-12,AR,15450,1904687,12210,482598,27660,2387285
3382,2021-01-12,AR,256,409226,0,32,72970,0,0,2021-01-12,AR,7309,1168906,20708,246691,28017,1415597
3383,2021-01-12,AR,256,409226,0,32,72970,0,0,2021-01-12,AR,24427,734936,1252,107569,25679,842505
3384,2021-01-12,AR,256,409226,0,32,72970,0,0,2021-01-12,AR,15936,287399,5859,62222,21795,349621
3385,2021-01-12,AR,256,409226,0,32,72970,0,0,2021-01-12,AR,593,53070,1646,34139,2239,87209
3386,2021-01-12,AR,256,409226,0,32,72970,0,0,2021-01-12,AR,2621,24065,0,6,2621,24071
3387,2021-01-02,AR,200,415256,0,26,73705,0,0,2021-01-02,AR,10730,5291964,22520,4340109,33250,9632073
3388,2021-01-02,AR,200,415256,0,26,73705,0,0,2021-01-02,AR,18701,4991605,20771,3785447,39472,8777052
3389,2021-01-02,AR,200,415256,0,26,73705,0,0,2021-01-02,AR,3938,4275104,23379,3315079,27317,7590183
3390,2021-01-02,AR,200,415256,0,26,73705,0,0,2021-01-02,AR,11108,4072823,51732,2295964,62840,6368787
3391,2021-01-02,AR,200,415256,0,26,73705,0,0,2021-01-02,AR,25296,3681724,34579,1083499,59875,4765223
3392,2021-01-02,AR,200,415256,0,26,73705,0,0,2021-01-02,AR,49047,2581736,11998,634479,61045,3216215
3393,2021-01-02,AR,200,415256,0,26,73705,0,0,2021-01-02,AR,35964,1489738,7291,431754,43255,1921492
3394,2021-01-02,AR,200,415256,0,26,73705,0,0,2021-01-02,AR,3440,1043134,1787,143309,5227,1186443
3395,2021-01-02,AR,200,415256,0,26,73705,0,0,2021-01-02,AR,9408,528039,110,99035,9518,627074
3396,2021-01-02,AR,200,415256,0,26,73705,0,0,2021-01-02,AR,9465,152502,1013,45054,10478,197556
3397,2021-01-02,AR,200,415256,0,26,73705,0,0,2021-01-02,AR,711,40684,2591,19198,3302,59882
3398,2021-01-02,AR,200,415256,0,26,73705,0,0,2021-01-02,AR,410,6425,0,0,410,6425
3399,2021-01-12,AR,337,417820,0,44,74007,0,0,2021-01-12,AR,1812,5351182,4839,4473614,6651,9824796
3400,2021-01-12,AR,337,417820,0,44,74007,0,0,2021-01-12,AR,11860,5149855,21444,3947404,33304,9097259
3401,2021-01-12,AR,337,417820,0,44,74007,0,0,2021-01-12,AR,29072,4361488,16975,3483913,46047,7845401
3402,2021-01-12,AR,337,417820,0,44,74007,0,0,2021-01-12,AR,298,4130723,872,2686606,1170,6817329
3403,2021-01-12,AR,337,417820,0,44,74007,0,0,2021-01-12,AR,11130,3848561,44884,1445763,56014,5294324
3404,2021-01-12,AR,337,417820,0,44,74007,0,0,2021-01-12,AR,49224,2948769,4017,737692,53241,3686461
3405,2021-01-12,AR,337,417820,0,44,74007,0,0,2021-01-12,AR,15450,1904687,12210,482598,27660,2387285
3406,2021-01-12,AR,337,417820,0,44,74007,0,0,2021-01-12,AR,7309,1168906,20708,246691,28017,1415597
3407,2021-01-12,AR,337,417820,0,44,74007,0,0,2021-01-12,AR,24427,734936,1252,107569,25679,842505
3408,2021-01-12,AR,337,417820,0,44,74007,0,0,2021-01-12,AR,15936,287399,5859,62222,21795,349621
3409,2021-01-12,AR,337,417820,0,44,74007,0,0,2021-01-12,AR,593,53070,1646,34139,2239,87209
3410,2021-01-12,AR,337,417820,0,44,74007,0,0,2021-01-12,AR,2621,24065,0,6,2621,24071
3411,2021-01-02,AR,268,423151,0,26,74617,0,0,2021-01-02,AR,10730,5291964,22520,4340109,33250,9632073
3412,2021-01-02,AR,268,423151,0,26,74617,0,0,2021-01-02,AR,18701,4991605,20771,3785447,39472,8777052
3413,2021-01-02,AR,268,423151,0,26,74617,0,0,2021-01-02,AR,3938,4275104,23379,3315079,27317,7590183
3414,2021-01-02,AR,268,423151,0,26,74617,0,0,2021-01-02,AR,11108,4072823,51732,2295964,62840,6368787
3415,2021-01-02,AR,268,423151,0,26,74617,0,0,2021-01-02,AR,25296,3681724,34579,1083499,59875,4765223
3416,2021-01-02,AR,268,423151,0,26,74617,0,0,2021-01-02,AR,49047,2581736,11998,634479,61045,3216215
3417,2021-01-02,AR,268,423151,0,26,74617,0,0,2021-01-02,AR,35964,1489738,7291,431754,43255,1921492
3418,2021-01-02,AR,268,423151,0,26,74617,0,0,2021-01-02,AR,3440,1043134,1787,143309,5227,1186443
3419,2021-01-02,AR,268,423151,0,26,74617,0,0,2021-01-02,AR,9408,528039,110,99035,9518,627074
3420,2021-01-02,AR,268,423151,0,26,74617,0,0,2021-01-02,AR,9465,152502,1013,45054,10478,197556
3421,2021-01-02,AR,268,423151,0,26,74617,0,0,2021-01-02,AR,711,40684,2591,19198,3302,59882
3422,2021-01-02,AR,268,423151,0,26,74617,0,0,2021-01-02,AR,410,6425,0,0,410,6425
3423,2021-01-12,AR,211,425429,0,21,74898,0,0,2021-01-12,AR,1812,5351182,4839,4473614,6651,9824796
3424,2021-01-12,AR,211,425429,0,21,74898,0,0,2021-01-12,AR,11860,5149855,21444,3947404,33304,9097259
3425,2021-01-12,AR,211,425429,0,21,74898,0,0,2021-01-12,AR,29072,4361488,16975,3483913,46047,7845401
3426,2021-01-12,AR,211,425429,0,21,74898,0,0,2021-01-12,AR,298,4130723,872,2686606,1170,6817329
3427,2021-01-12,AR,211,425429,0,21,74898,0,0,2021-01-12,AR,11130,3848561,44884,1445763,56014,5294324
3428,2021-01-12,AR,211,425429,0,21,74898,0,0,2021-01-12,AR,49224,2948769,4017,737692,53241,3686461
3429,2021-01-12,AR,211,425429,0,21,74898,0,0,2021-01-12,AR,15450,1904687,12210,482598,27660,2387285
3430,2021-01-12,AR,211,425429,0,21,74898,0,0,2021-01-12,AR,7309,1168906,20708,246691,28017,1415597
3431,2021-01-12,AR,211,425429,0,21,74898,0,0,2021-01-12,AR,24427,734936,1252,107569,25679,842505
3432,2021-01-12,AR,211,425429,0,21,74898,0,0,2021-01-12,AR,15936,287399,5859,62222,21795,349621
3433,2021-01-12,AR,211,425429,0,21,74898,0,0,2021-01-12,AR,593,53070,1646,34139,2239,87209
3434,2021-01-12,AR,211,425429,0,21,74898,0,0,2021-01-12,AR,2621,24065,0,6,2621,24071
3435,2021-01-02,AR,232,429869,0,29,75500,0,0,2021-01-02,AR,10730,5291964,22520,4340109,33250,9632073
3436,2021-01-02,AR,232,429869,0,29,75500,0,0,2021-01-02,AR,18701,4991605,20771,3785447,39472,8777052
3437,2021-01-02,AR,232,429869,0,29,75500,0,0,2021-01-02,AR,3938,4275104,23379,3315079,27317,7590183
3438,2021-01-02,AR,232,429869,0,29,75500,0,0,2021-01-02,AR,11108,4072823,51732,2295964,62840,6368787
3439,2021-01-02,AR,232,429869,0,29,75500,0,0,2021-01-02,AR,25296,3681724,34579,1083499,59875,4765223
3440,2021-01-02,AR,232,429869,0,29,75500,0,0,2021-01-02,AR,49047,2581736,11998,634479,61045,3216215
3441,2021-01-02,AR,232,429869,0,29,75500,0,0,2021-01-02,AR,35964,1489738,7291,431754,43255,1921492
3442,2021-01-02,AR,232,429869,0,29,75500,0,0,2021-01-02,AR,3440,1043134,1787,143309,5227,1186443
3443,2021-01-02,AR,232,429869,0,29,75500,0,0,2021-01-02,AR,9408,528039,110,99035,9518,627074
3444,2021-01-02,AR,232,429869,0,29,75500,0,0,2021-01-02,AR,9465,152502,1013,45054,10478,197556
3445,2021-01-02,AR,232,429869,0,29,75500,0,0,2021-01-02,AR,711,40684,2591,19198,3302,59882
3446,2021-01-02,AR,232,429869,0,29,75500,0,0,2021-01-02,AR,410,6425,0,0,410,6425
3447,2021-01-12,AR,194,431948,0,26,75763,0,0,2021-01-12,AR,1812,5351182,4839,4473614,6651,9824796
3448,2021-01-12,AR,194,431948,0,26,75763,0,0,2021-01-12,AR,11860,5149855,21444,3947404,33304,9097259
3449,2021-01-12,AR,194,431948,0,26,75763,0,0,2021-01-12,AR,29072,4361488,16975,3483913,46047,7845401
3450,2021-01-12,AR,194,431948,0,26,75763,0,0,2021-01-12,AR,298,4130723,872,2686606,1170,6817329
3451,2021-01-12,AR,194,431948,0,26,75763,0,0,2021-01-12,AR,11130,3848561,44884,1445763,56014,5294324
3452,2021-01-12,AR,194,431948,0,26,75763,0,0,2021-01-12,AR,49224,2948769,4017,737692,53241,3686461
3453,2021-01-12,AR,194,431948,0,26,75763,0,0,2021-01-12,AR,15450,1904687,12210,482598,27660,2387285
3454,2021-01-12,AR,194,431948,0,26,75763,0,0,2021-01-12,AR,7309,1168906,20708,246691,28017,1415597
3455,2021-01-12,AR,194,431948,0,26,75763,0,0,2021-01-12,AR,24427,734936,1252,107569,25679,842505
3456,2021-01-12,AR,194,431948,0,26,75763,0,0,2021-01-12,AR,15936,287399,5859,62222,21795,349621
3457,2021-01-12,AR,194,431948,0,26,75763,0,0,2021-01-12,AR,593,53070,1646,34139,2239,87209
3458,2021-01-12,AR,194,431948,0,26,75763,0,0,2021-01-12,AR,2621,24065,0,6,2621,24071
3459,2021-01-14,AR,611,241669,0,97,38775,0,0,2021-01-14,AR,7584,5365894,16850,4507067,24434,9872961
3460,2021-01-14,AR,611,241669,0,97,38775,0,0,2021-01-14,AR,265,5155417,736,3957147,1001,9112564
3461,2021-01-14,AR,611,241669,0,97,38775,0,0,2021-01-14,AR,38259,4435237,22239,3522556,60498,7957793
3462,2021-01-14,AR,611,241669,0,97,38775,0,0,2021-01-14,AR,6370,4144108,32958,2754984,39328,6899092
3463,2021-01-14,AR,611,241669,0,97,38775,0,0,2021-01-14,AR,5162,3863606,31104,1526011,36266,5389617
3464,2021-01-14,AR,611,241669,0,97,38775,0,0,2021-01-14,AR,50761,3050411,4753,746316,55514,3796727
3465,2021-01-14,AR,611,241669,0,97,38775,0,0,2021-01-14,AR,22733,1933109,12579,501646,35312,2434755
3466,2021-01-14,AR,611,241669,0,97,38775,0,0,2021-01-14,AR,5417,1179523,21415,289425,26832,1468948
3467,2021-01-14,AR,611,241669,0,97,38775,0,0,2021-01-14,AR,22521,780426,1970,112938,24491,893364
3468,2021-01-14,AR,611,241669,0,97,38775,0,0,2021-01-14,AR,1094,291147,156,66006,1250,357153
3469,2021-01-14,AR,611,241669,0,97,38775,0,0,2021-01-14,AR,4,53130,19,34551,23,87681
3470,2021-01-14,AR,611,241669,0,97,38775,0,0,2021-01-14,AR,2243,28463,0,6,2243,28469
3471,2021-01-14,AR,367,257222,0,74,41907,0,0,2021-01-14,AR,7584,5365894,16850,4507067,24434,9872961
3472,2021-01-14,AR,367,257222,0,74,41907,0,0,2021-01-14,AR,265,5155417,736,3957147,1001,9112564
3473,2021-01-14,AR,367,257222,0,74,41907,0,0,2021-01-14,AR,38259,4435237,22239,3522556,60498,7957793
3474,2021-01-14,AR,367,257222,0,74,41907,0,0,2021-01-14,AR,6370,4144108,32958,2754984,39328,6899092
3475,2021-01-14,AR,367,257222,0,74,41907,0,0,2021-01-14,AR,5162,3863606,31104,1526011,36266,5389617
3476,2021-01-14,AR,367,257222,0,74,41907,0,0,2021-01-14,AR,50761,3050411,4753,746316,55514,3796727
3477,2021-01-14,AR,367,257222,0,74,41907,0,0,2021-01-14,AR,22733,1933109,12579,501646,35312,2434755
3478,2021-01-14,AR,367,257222,0,74,41907,0,0,2021-01-14,AR,5417,1179523,21415,289425,26832,1468948
3479,2021-01-14,AR,367,257222,0,74,41907,0,0,2021-01-14,AR,22521,780426,1970,112938,24491,893364
3480,2021-01-14,AR,367,257222,0,74,41907,0,0,2021-01-14,AR,1094,291147,156,66006,1250,357153
3481,2021-01-14,AR,367,257222,0,74,41907,0,0,2021-01-14,AR,4,53130,19,34551,23,87681
3482,2021-01-14,AR,367,257222,0,74,41907,0,0,2021-01-14,AR,2243,28463,0,6,2243,28469
3483,2021-01-14,AR,400,269578,0,83,44269,0,0,2021-01-14,AR,7584,5365894,16850,4507067,24434,9872961
3484,2021-01-14,AR,400,269578,0,83,44269,0,0,2021-01-14,AR,265,5155417,736,3957147,1001,9112564
3485,2021-01-14,AR,400,269578,0,83,44269,0,0,2021-01-14,AR,38259,4435237,22239,3522556,60498,7957793
3486,2021-01-14,AR,400,269578,0,83,44269,0,0,2021-01-14,AR,6370,4144108,32958,2754984,39328,6899092
3487,2021-01-14,AR,400,269578,0,83,44269,0,0,2021-01-14,AR,5162,3863606,31104,1526011,36266,5389617
3488,2021-01-14,AR,400,269578,0,83,44269,0,0,2021-01-14,AR,50761,3050411,4753,746316,55514,3796727
3489,2021-01-14,AR,400,269578,0,83,44269,0,0,2021-01-14,AR,22733,1933109,12579,501646,35312,2434755
3490,2021-01-14,AR,400,269578,0,83,44269,0,0,2021-01-14,AR,5417,1179523,21415,289425,26832,1468948
3491,2021-01-14,AR,400,269578,0,83,44269,0,0,2021-01-14,AR,22521,780426,1970,112938,24491,893364
3492,2021-01-14,AR,400,269578,0,83,44269,0,0,2021-01-14,AR,1094,291147,156,66006,1250,357153
3493,2021-01-14,AR,400,269578,0,83,44269,0,0,2021-01-14,AR,4,53130,19,34551,23,87681
3494,2021-01-14,AR,400,269578,0,83,44269,0,0,2021-01-14,AR,2243,28463,0,6,2243,28469
3495,2021-01-14,AR,1013,288908,0,188,48203,0,0,2021-01-14,AR,7584,5365894,16850,4507067,24434,9872961
3496,2021-01-14,AR,1013,288908,0,188,48203,0,0,2021-01-14,AR,265,5155417,736,3957147,1001,9112564
3497,2021-01-14,AR,1013,288908,0,188,48203,0,0,2021-01-14,AR,38259,4435237,22239,3522556,60498,7957793
3498,2021-01-14,AR,1013,288908,0,188,48203,0,0,2021-01-14,AR,6370,4144108,32958,2754984,39328,6899092
3499,2021-01-14,AR,1013,288908,0,188,48203,0,0,2021-01-14,AR,5162,3863606,31104,1526011,36266,5389617
3500,2021-01-14,AR,1013,288908,0,188,48203,0,0,2021-01-14,AR,50761,3050411,4753,746316,55514,3796727
3501,2021-01-14,AR,1013,288908,0,188,48203,0,0,2021-01-14,AR,22733,1933109,12579,501646,35312,2434755
3502,2021-01-14,AR,1013,288908,0,188,48203,0,0,2021-01-14,AR,5417,1179523,21415,289425,26832,1468948
3503,2021-01-14,AR,1013,288908,0,188,48203,0,0,2021-01-14,AR,22521,780426,1970,112938,24491,893364
3504,2021-01-14,AR,1013,288908,0,188,48203,0,0,2021-01-14,AR,1094,291147,156,66006,1250,357153
3505,2021-01-14,AR,1013,288908,0,188,48203,0,0,2021-01-14,AR,4,53130,19,34551,23,87681
3506,2021-01-14,AR,1013,288908,0,188,48203,0,0,2021-01-14,AR,2243,28463,0,6,2243,28469
3507,2021-01-14,AR,987,316786,0,213,54270,0,0,2021-01-14,AR,7584,5365894,16850,4507067,24434,9872961
3508,2021-01-14,AR,987,316786,0,213,54270,0,0,2021-01-14,AR,265,5155417,736,3957147,1001,9112564
3509,2021-01-14,AR,987,316786,0,213,54270,0,0,2021-01-14,AR,38259,4435237,22239,3522556,60498,7957793
3510,2021-01-14,AR,987,316786,0,213,54270,0,0,2021-01-14,AR,6370,4144108,32958,2754984,39328,6899092
3511,2021-01-14,AR,987,316786,0,213,54270,0,0,2021-01-14,AR,5162,3863606,31104,1526011,36266,5389617
3512,2021-01-14,AR,987,316786,0,213,54270,0,0,2021-01-14,AR,50761,3050411,4753,746316,55514,3796727
3513,2021-01-14,AR,987,316786,0,213,54270,0,0,2021-01-14,AR,22733,1933109,12579,501646,35312,2434755
3514,2021-01-14,AR,987,316786,0,213,54270,0,0,2021-01-14,AR,5417,1179523,21415,289425,26832,1468948
3515,2021-01-14,AR,987,316786,0,213,54270,0,0,2021-01-14,AR,22521,780426,1970,112938,24491,893364
3516,2021-01-14,AR,987,316786,0,213,54270,0,0,2021-01-14,AR,1094,291147,156,66006,1250,357153
3517,2021-01-14,AR,987,316786,0,213,54270,0,0,2021-01-14,AR,4,53130,19,34551,23,87681
3518,2021-01-14,AR,987,316786,0,213,54270,0,0,2021-01-14,AR,2243,28463,0,6,2243,28469
3519,2021-01-14,AR,1053,351634,0,214,62024,0,0,2021-01-14,AR,7584,5365894,16850,4507067,24434,9872961
3520,2021-01-14,AR,1053,351634,0,214,62024,0,0,2021-01-14,AR,265,5155417,736,3957147,1001,9112564
3521,2021-01-14,AR,1053,351634,0,214,62024,0,0,2021-01-14,AR,38259,4435237,22239,3522556,60498,7957793
3522,2021-01-14,AR,1053,351634,0,214,62024,0,0,2021-01-14,AR,6370,4144108,32958,2754984,39328,6899092
3523,2021-01-14,AR,1053,351634,0,214,62024,0,0,2021-01-14,AR,5162,3863606,31104,1526011,36266,5389617
3524,2021-01-14,AR,1053,351634,0,214,62024,0,0,2021-01-14,AR,50761,3050411,4753,746316,55514,3796727
3525,2021-01-14,AR,1053,351634,0,214,62024,0,0,2021-01-14,AR,22733,1933109,12579,501646,35312,2434755
3526,2021-01-14,AR,1053,351634,0,214,62024,0,0,2021-01-14,AR,5417,1179523,21415,289425,26832,1468948
3527,2021-01-14,AR,1053,351634,0,214,62024,0,0,2021-01-14,AR,22521,780426,1970,112938,24491,893364
3528,2021-01-14,AR,1053,351634,0,214,62024,0,0,2021-01-14,AR,1094,291147,156,66006,1250,357153
3529,2021-01-14,AR,1053,351634,0,214,62024,0,0,2021-01-14,AR,4,53130,19,34551,23,87681
3530,2021-01-14,AR,1053,351634,0,214,62024,0,0,2021-01-14,AR,2243,28463,0,6,2243,28469
3531,2021-01-14,AR,862,377014,0,174,67281,0,0,2021-01-14,AR,7584,5365894,16850,4507067,24434,9872961
3532,2021-01-14,AR,862,377014,0,174,67281,0,0,2021-01-14,AR,265,5155417,736,3957147,1001,9112564
3533,2021-01-14,AR,862,377014,0,174,67281,0,0,2021-01-14,AR,38259,4435237,22239,3522556,60498,7957793
3534,2021-01-14,AR,862,377014,0,174,67281,0,0,2021-01-14,AR,6370,4144108,32958,2754984,39328,6899092
3535,2021-01-14,AR,862,377014,0,174,67281,0,0,2021-01-14,AR,5162,3863606,31104,1526011,36266,5389617
3536,2021-01-14,AR,862,377014,0,174,67281,0,0,2021-01-14,AR,50761,3050411,4753,746316,55514,3796727
3537,2021-01-14,AR,862,377014,0,174,67281,0,0,2021-01-14,AR,22733,1933109,12579,501646,35312,2434755
3538,2021-01-14,AR,862,377014,0,174,67281,0,0,2021-01-14,AR,5417,1179523,21415,289425,26832,1468948
3539,2021-01-14,AR,862,377014,0,174,67281,0,0,2021-01-14,AR,22521,780426,1970,112938,24491,893364
3540,2021-01-14,AR,862,377014,0,174,67281,0,0,2021-01-14,AR,1094,291147,156,66006,1250,357153
3541,2021-01-14,AR,862,377014,0,174,67281,0,0,2021-01-14,AR,4,53130,19,34551,23,87681
3542,2021-01-14,AR,862,377014,0,174,67281,0,0,2021-01-14,AR,2243,28463,0,6,2243,28469
3543,2021-01-14,AR,465,396556,0,94,70981,0,0,2021-01-14,AR,7584,5365894,16850,4507067,24434,9872961
3544,2021-01-14,AR,465,396556,0,94,70981,0,0,2021-01-14,AR,265,5155417,736,3957147,1001,9112564
3545,2021-01-14,AR,465,396556,0,94,70981,0,0,2021-01-14,AR,38259,4435237,22239,3522556,60498,7957793
3546,2021-01-14,AR,465,396556,0,94,70981,0,0,2021-01-14,AR,6370,4144108,32958,2754984,39328,6899092
3547,2021-01-14,AR,465,396556,0,94,70981,0,0,2021-01-14,AR,5162,3863606,31104,1526011,36266,5389617
3548,2021-01-14,AR,465,396556,0,94,70981,0,0,2021-01-14,AR,50761,3050411,4753,746316,55514,3796727
3549,2021-01-14,AR,465,396556,0,94,70981,0,0,2021-01-14,AR,22733,1933109,12579,501646,35312,2434755
3550,2021-01-14,AR,465,396556,0,94,70981,0,0,2021-01-14,AR,5417,1179523,21415,289425,26832,1468948
3551,2021-01-14,AR,465,396556,0,94,70981,0,0,2021-01-14,AR,22521,780426,1970,112938,24491,893364
3552,2021-01-14,AR,465,396556,0,94,70981,0,0,2021-01-14,AR,1094,291147,156,66006,1250,357153
3553,2021-01-14,AR,465,396556,0,94,70981,0,0,2021-01-14,AR,4,53130,19,34551,23,87681
3554,2021-01-14,AR,465,396556,0,94,70981,0,0,2021-01-14,AR,2243,28463,0,6,2243,28469
3555,2021-01-14,AR,341,410035,0,38,73066,0,0,2021-01-14,AR,7584,5365894,16850,4507067,24434,9872961
3556,2021-01-14,AR,341,410035,0,38,73066,0,0,2021-01-14,AR,265,5155417,736,3957147,1001,9112564
3557,2021-01-14,AR,341,410035,0,38,73066,0,0,2021-01-14,AR,38259,4435237,22239,3522556,60498,7957793
3558,2021-01-14,AR,341,410035,0,38,73066,0,0,2021-01-14,AR,6370,4144108,32958,2754984,39328,6899092
3559,2021-01-14,AR,341,410035,0,38,73066,0,0,2021-01-14,AR,5162,3863606,31104,1526011,36266,5389617
3560,2021-01-14,AR,341,410035,0,38,73066,0,0,2021-01-14,AR,50761,3050411,4753,746316,55514,3796727
3561,2021-01-14,AR,341,410035,0,38,73066,0,0,2021-01-14,AR,22733,1933109,12579,501646,35312,2434755
3562,2021-01-14,AR,341,410035,0,38,73066,0,0,2021-01-14,AR,5417,1179523,21415,289425,26832,1468948
3563,2021-01-14,AR,341,410035,0,38,73066,0,0,2021-01-14,AR,22521,780426,1970,112938,24491,893364
3564,2021-01-14,AR,341,410035,0,38,73066,0,0,2021-01-14,AR,1094,291147,156,66006,1250,357153
3565,2021-01-14,AR,341,410035,0,38,73066,0,0,2021-01-14,AR,4,53130,19,34551,23,87681
3566,2021-01-14,AR,341,410035,0,38,73066,0,0,2021-01-14,AR,2243,28463,0,6,2243,28469
3567,2021-01-14,AR,290,418437,0,30,74078,0,0,2021-01-14,AR,7584,5365894,16850,4507067,24434,9872961
3568,2021-01-14,AR,290,418437,0,30,74078,0,0,2021-01-14,AR,265,5155417,736,3957147,1001,9112564
3569,2021-01-14,AR,290,418437,0,30,74078,0,0,2021-01-14,AR,38259,4435237,22239,3522556,60498,7957793
3570,2021-01-14,AR,290,418437,0,30,74078,0,0,2021-01-14,AR,6370,4144108,32958,2754984,39328,6899092
3571,2021-01-14,AR,290,418437,0,30,74078,0,0,2021-01-14,AR,5162,3863606,31104,1526011,36266,5389617
3572,2021-01-14,AR,290,418437,0,30,74078,0,0,2021-01-14,AR,50761,3050411,4753,746316,55514,3796727
3573,2021-01-14,AR,290,418437,0,30,74078,0,0,2021-01-14,AR,22733,1933109,12579,501646,35312,2434755
3574,2021-01-14,AR,290,418437,0,30,74078,0,0,2021-01-14,AR,5417,1179523,21415,289425,26832,1468948
3575,2021-01-14,AR,290,418437,0,30,74078,0,0,2021-01-14,AR,22521,780426,1970,112938,24491,893364
3576,2021-01-14,AR,290,418437,0,30,74078,0,0,2021-01-14,AR,1094,291147,156,66006,1250,357153
3577,2021-01-14,AR,290,418437,0,30,74078,0,0,2021-01-14,AR,4,53130,19,34551,23,87681
3578,2021-01-14,AR,290,418437,0,30,74078,0,0,2021-01-14,AR,2243,28463,0,6,2243,28469
3579,2021-01-14,AR,181,425805,0,19,74940,0,0,2021-01-14,AR,7584,5365894,16850,4507067,24434,9872961
3580,2021-01-14,AR,181,425805,0,19,74940,0,0,2021-01-14,AR,265,5155417,736,3957147,1001,9112564
3581,2021-01-14,AR,181,425805,0,19,74940,0,0,2021-01-14,AR,38259,4435237,22239,3522556,60498,7957793
3582,2021-01-14,AR,181,425805,0,19,74940,0,0,2021-01-14,AR,6370,4144108,32958,2754984,39328,6899092
3583,2021-01-14,AR,181,425805,0,19,74940,0,0,2021-01-14,AR,5162,3863606,31104,1526011,36266,5389617
3584,2021-01-14,AR,181,425805,0,19,74940,0,0,2021-01-14,AR,50761,3050411,4753,746316,55514,3796727
3585,2021-01-14,AR,181,425805,0,19,74940,0,0,2021-01-14,AR,22733,1933109,12579,501646,35312,2434755
3586,2021-01-14,AR,181,425805,0,19,74940,0,0,2021-01-14,AR,5417,1179523,21415,289425,26832,1468948
3587,2021-01-14,AR,181,425805,0,19,74940,0,0,2021-01-14,AR,22521,780426,1970,112938,24491,893364
3588,2021-01-14,AR,181,425805,0,19,74940,0,0,2021-01-14,AR,1094,291147,156,66006,1250,357153
3589,2021-01-14,AR,181,425805,0,19,74940,0,0,2021-01-14,AR,4,53130,19,34551,23,87681
3590,2021-01-14,AR,181,425805,0,19,74940,0,0,2021-01-14,AR,2243,28463,0,6,2243,28469
3591,2021-01-14,AR,259,432470,0,44,75846,0,0,2021-01-14,AR,7584,5365894,16850,4507067,24434,9872961
3592,2021-01-14,AR,259,432470,0,44,75846,0,0,2021-01-14,AR,265,5155417,736,3957147,1001,9112564
3593,2021-01-14,AR,259,432470,0,44,75846,0,0,2021-01-14,AR,38259,4435237,22239,3522556,60498,7957793
3594,2021-01-14,AR,259,432470,0,44,75846,0,0,2021-01-14,AR,6370,4144108,32958,2754984,39328,6899092
3595,2021-01-14,AR,259,432470,0,44,75846,0,0,2021-01-14,AR,5162,3863606,31104,1526011,36266,5389617
3596,2021-01-14,AR,259,432470,0,44,75846,0,0,2021-01-14,AR,50761,3050411,4753,746316,55514,3796727
3597,2021-01-14,AR,259,432470,0,44,75846,0,0,2021-01-14,AR,22733,1933109,12579,501646,35312,2434755
3598,2021-01-14,AR,259,432470,0,44,75846,0,0,2021-01-14,AR,5417,1179523,21415,289425,26832,1468948
3599,2021-01-14,AR,259,432470,0,44,75846,0,0,2021-01-14,AR,22521,780426,1970,112938,24491,893364
3600,2021-01-14,AR,259,432470,0,44,75846,0,0,2021-01-14,AR,1094,291147,156,66006,1250,357153
3601,2021-01-14,AR,259,432470,0,44,75846,0,0,2021-01-14,AR,4,53130,19,34551,23,87681
3602,2021-01-14,AR,259,432470,0,44,75846,0,0,2021-01-14,AR,2243,28463,0,6,2243,28469
3603,2021-01-13,AR,678,241058,0,131,38678,0,0,2021-01-13,AR,7128,5358310,16603,4490217,23731,9848527
3604,2021-01-13,AR,678,241058,0,131,38678,0,0,2021-01-13,AR,5297,5155152,9007,3956411,14304,9111563
3605,2021-01-13,AR,678,241058,0,131,38678,0,0,2021-01-13,AR,35490,4396978,16404,3500317,51894,7897295
3606,2021-01-13,AR,678,241058,0,131,38678,0,0,2021-01-13,AR,7015,4137738,35420,2722026,42435,6859764
3607,2021-01-13,AR,678,241058,0,131,38678,0,0,2021-01-13,AR,9883,3858444,49144,1494907,59027,5353351
3608,2021-01-13,AR,678,241058,0,131,38678,0,0,2021-01-13,AR,50881,2999650,3871,741563,54752,3741213
3609,2021-01-13,AR,678,241058,0,131,38678,0,0,2021-01-13,AR,5689,1910376,6469,489067,12158,2399443
3610,2021-01-13,AR,678,241058,0,131,38678,0,0,2021-01-13,AR,5200,1174106,21319,268010,26519,1442116
3611,2021-01-13,AR,678,241058,0,131,38678,0,0,2021-01-13,AR,22969,757905,3399,110968,26368,868873
3612,2021-01-13,AR,678,241058,0,131,38678,0,0,2021-01-13,AR,2654,290053,3628,65850,6282,355903
3613,2021-01-13,AR,678,241058,0,131,38678,0,0,2021-01-13,AR,56,53126,393,34532,449,87658
3614,2021-01-13,AR,678,241058,0,131,38678,0,0,2021-01-13,AR,2155,26220,0,6,2155,26226
3615,2021-01-13,AR,383,256855,0,85,41833,0,0,2021-01-13,AR,7128,5358310,16603,4490217,23731,9848527
3616,2021-01-13,AR,383,256855,0,85,41833,0,0,2021-01-13,AR,5297,5155152,9007,3956411,14304,9111563
3617,2021-01-13,AR,383,256855,0,85,41833,0,0,2021-01-13,AR,35490,4396978,16404,3500317,51894,7897295
3618,2021-01-13,AR,383,256855,0,85,41833,0,0,2021-01-13,AR,7015,4137738,35420,2722026,42435,6859764
3619,2021-01-13,AR,383,256855,0,85,41833,0,0,2021-01-13,AR,9883,3858444,49144,1494907,59027,5353351
3620,2021-01-13,AR,383,256855,0,85,41833,0,0,2021-01-13,AR,50881,2999650,3871,741563,54752,3741213
3621,2021-01-13,AR,383,256855,0,85,41833,0,0,2021-01-13,AR,5689,1910376,6469,489067,12158,2399443
3622,2021-01-13,AR,383,256855,0,85,41833,0,0,2021-01-13,AR,5200,1174106,21319,268010,26519,1442116
3623,2021-01-13,AR,383,256855,0,85,41833,0,0,2021-01-13,AR,22969,757905,3399,110968,26368,868873
3624,2021-01-13,AR,383,256855,0,85,41833,0,0,2021-01-13,AR,2654,290053,3628,65850,6282,355903
3625,2021-01-13,AR,383,256855,0,85,41833,0,0,2021-01-13,AR,56,53126,393,34532,449,87658
3626,2021-01-13,AR,383,256855,0,85,41833,0,0,2021-01-13,AR,2155,26220,0,6,2155,26226
3627,2021-01-13,AR,390,269178,0,98,44186,0,0,2021-01-13,AR,7128,5358310,16603,4490217,23731,9848527
3628,2021-01-13,AR,390,269178,0,98,44186,0,0,2021-01-13,AR,5297,5155152,9007,3956411,14304,9111563
3629,2021-01-13,AR,390,269178,0,98,44186,0,0,2021-01-13,AR,35490,4396978,16404,3500317,51894,7897295
3630,2021-01-13,AR,390,269178,0,98,44186,0,0,2021-01-13,AR,7015,4137738,35420,2722026,42435,6859764
3631,2021-01-13,AR,390,269178,0,98,44186,0,0,2021-01-13,AR,9883,3858444,49144,1494907,59027,5353351
3632,2021-01-13,AR,390,269178,0,98,44186,0,0,2021-01-13,AR,50881,2999650,3871,741563,54752,3741213
3633,2021-01-13,AR,390,269178,0,98,44186,0,0,2021-01-13,AR,5689,1910376,6469,489067,12158,2399443
3634,2021-01-13,AR,390,269178,0,98,44186,0,0,2021-01-13,AR,5200,1174106,21319,268010,26519,1442116
3635,2021-01-13,AR,390,269178,0,98,44186,0,0,2021-01-13,AR,22969,757905,3399,110968,26368,868873
3636,2021-01-13,AR,390,269178,0,98,44186,0,0,2021-01-13,AR,2654,290053,3628,65850,6282,355903
3637,2021-01-13,AR,390,269178,0,98,44186,0,0,2021-01-13,AR,56,53126,393,34532,449,87658
3638,2021-01-13,AR,390,269178,0,98,44186,0,0,2021-01-13,AR,2155,26220,0,6,2155,26226
3639,2021-01-13,AR,966,287895,0,198,48015,0,0,2021-01-13,AR,7128,5358310,16603,4490217,23731,9848527
3640,2021-01-13,AR,966,287895,0,198,48015,0,0,2021-01-13,AR,5297,5155152,9007,3956411,14304,9111563
3641,2021-01-13,AR,966,287895,0,198,48015,0,0,2021-01-13,AR,35490,4396978,16404,3500317,51894,7897295
3642,2021-01-13,AR,966,287895,0,198,48015,0,0,2021-01-13,AR,7015,4137738,35420,2722026,42435,6859764
3643,2021-01-13,AR,966,287895,0,198,48015,0,0,2021-01-13,AR,9883,3858444,49144,1494907,59027,5353351
3644,2021-01-13,AR,966,287895,0,198,48015,0,0,2021-01-13,AR,50881,2999650,3871,741563,54752,3741213
3645,2021-01-13,AR,966,287895,0,198,48015,0,0,2021-01-13,AR,5689,1910376,6469,489067,12158,2399443
3646,2021-01-13,AR,966,287895,0,198,48015,0,0,2021-01-13,AR,5200,1174106,21319,268010,26519,1442116
3647,2021-01-13,AR,966,287895,0,198,48015,0,0,2021-01-13,AR,22969,757905,3399,110968,26368,868873
3648,2021-01-13,AR,966,287895,0,198,48015,0,0,2021-01-13,AR,2654,290053,3628,65850,6282,355903
3649,2021-01-13,AR,966,287895,0,198,48015,0,0,2021-01-13,AR,56,53126,393,34532,449,87658
3650,2021-01-13,AR,966,287895,0,198,48015,0,0,2021-01-13,AR,2155,26220,0,6,2155,26226
3651,2021-01-13,AR,1050,315799,0,209,54057,0,0,2021-01-13,AR,7128,5358310,16603,4490217,23731,9848527
3652,2021-01-13,AR,1050,315799,0,209,54057,0,0,2021-01-13,AR,5297,5155152,9007,3956411,14304,9111563
3653,2021-01-13,AR,1050,315799,0,209,54057,0,0,2021-01-13,AR,35490,4396978,16404,3500317,51894,7897295
3654,2021-01-13,AR,1050,315799,0,209,54057,0,0,2021-01-13,AR,7015,4137738,35420,2722026,42435,6859764
3655,2021-01-13,AR,1050,315799,0,209,54057,0,0,2021-01-13,AR,9883,3858444,49144,1494907,59027,5353351
3656,2021-01-13,AR,1050,315799,0,209,54057,0,0,2021-01-13,AR,50881,2999650,3871,741563,54752,3741213
3657,2021-01-13,AR,1050,315799,0,209,54057,0,0,2021-01-13,AR,5689,1910376,6469,489067,12158,2399443
3658,2021-01-13,AR,1050,315799,0,209,54057,0,0,2021-01-13,AR,5200,1174106,21319,268010,26519,1442116
3659,2021-01-13,AR,1050,315799,0,209,54057,0,0,2021-01-13,AR,22969,757905,3399,110968,26368,868873
3660,2021-01-13,AR,1050,315799,0,209,54057,0,0,2021-01-13,AR,2654,290053,3628,65850,6282,355903
3661,2021-01-13,AR,1050,315799,0,209,54057,0,0,2021-01-13,AR,56,53126,393,34532,449,87658
3662,2021-01-13,AR,1050,315799,0,209,54057,0,0,2021-01-13,AR,2155,26220,0,6,2155,26226
3663,2021-01-13,AR,853,350581,0,212,61810,0,0,2021-01-13,AR,7128,5358310,16603,4490217,23731,9848527
3664,2021-01-13,AR,853,350581,0,212,61810,0,0,2021-01-13,AR,5297,5155152,9007,3956411,14304,9111563
3665,2021-01-13,AR,853,350581,0,212,61810,0,0,2021-01-13,AR,35490,4396978,16404,3500317,51894,7897295
3666,2021-01-13,AR,853,350581,0,212,61810,0,0,2021-01-13,AR,7015,4137738,35420,2722026,42435,6859764
3667,2021-01-13,AR,853,350581,0,212,61810,0,0,2021-01-13,AR,9883,3858444,49144,1494907,59027,5353351
3668,2021-01-13,AR,853,350581,0,212,61810,0,0,2021-01-13,AR,50881,2999650,3871,741563,54752,3741213
3669,2021-01-13,AR,853,350581,0,212,61810,0,0,2021-01-13,AR,5689,1910376,6469,489067,12158,2399443
3670,2021-01-13,AR,853,350581,0,212,61810,0,0,2021-01-13,AR,5200,1174106,21319,268010,26519,1442116
3671,2021-01-13,AR,853,350581,0,212,61810,0,0,2021-01-13,AR,22969,757905,3399,110968,26368,868873
3672,2021-01-13,AR,853,350581,0,212,61810,0,0,2021-01-13,AR,2654,290053,3628,65850,6282,355903
3673,2021-01-13,AR,853,350581,0,212,61810,0,0,2021-01-13,AR,56,53126,393,34532,449,87658
3674,2021-01-13,AR,853,350581,0,212,61810,0,0,2021-01-13,AR,2155,26220,0,6,2155,26226
3675,2021-01-13,AR,875,376152,0,141,67107,0,0,2021-01-13,AR,7128,5358310,16603,4490217,23731,9848527
3676,2021-01-13,AR,875,376152,0,141,67107,0,0,2021-01-13,AR,5297,5155152,9007,3956411,14304,9111563
3677,2021-01-13,AR,875,376152,0,141,67107,0,0,2021-01-13,AR,35490,4396978,16404,3500317,51894,7897295
3678,2021-01-13,AR,875,376152,0,141,67107,0,0,2021-01-13,AR,7015,4137738,35420,2722026,42435,6859764
3679,2021-01-13,AR,875,376152,0,141,67107,0,0,2021-01-13,AR,9883,3858444,49144,1494907,59027,5353351
3680,2021-01-13,AR,875,376152,0,141,67107,0,0,2021-01-13,AR,50881,2999650,3871,741563,54752,3741213
3681,2021-01-13,AR,875,376152,0,141,67107,0,0,2021-01-13,AR,5689,1910376,6469,489067,12158,2399443
3682,2021-01-13,AR,875,376152,0,141,67107,0,0,2021-01-13,AR,5200,1174106,21319,268010,26519,1442116
3683,2021-01-13,AR,875,376152,0,141,67107,0,0,2021-01-13,AR,22969,757905,3399,110968,26368,868873
3684,2021-01-13,AR,875,376152,0,141,67107,0,0,2021-01-13,AR,2654,290053,3628,65850,6282,355903
3685,2021-01-13,AR,875,376152,0,141,67107,0,0,2021-01-13,AR,56,53126,393,34532,449,87658
3686,2021-01-13,AR,875,376152,0,141,67107,0,0,2021-01-13,AR,2155,26220,0,6,2155,26226
3687,2021-01-13,AR,504,396091,0,84,70887,0,0,2021-01-13,AR,7128,5358310,16603,4490217,23731,9848527
3688,2021-01-13,AR,504,396091,0,84,70887,0,0,2021-01-13,AR,5297,5155152,9007,3956411,14304,9111563
3689,2021-01-13,AR,504,396091,0,84,70887,0,0,2021-01-13,AR,35490,4396978,16404,3500317,51894,7897295
3690,2021-01-13,AR,504,396091,0,84,70887,0,0,2021-01-13,AR,7015,4137738,35420,2722026,42435,6859764
3691,2021-01-13,AR,504,396091,0,84,70887,0,0,2021-01-13,AR,9883,3858444,49144,1494907,59027,5353351
3692,2021-01-13,AR,504,396091,0,84,70887,0,0,2021-01-13,AR,50881,2999650,3871,741563,54752,3741213
3693,2021-01-13,AR,504,396091,0,84,70887,0,0,2021-01-13,AR,5689,1910376,6469,489067,12158,2399443
3694,2021-01-13,AR,504,396091,0,84,70887,0,0,2021-01-13,AR,5200,1174106,21319,268010,26519,1442116
3695,2021-01-13,AR,504,396091,0,84,70887,0,0,2021-01-13,AR,22969,757905,3399,110968,26368,868873
3696,2021-01-13,AR,504,396091,0,84,70887,0,0,2021-01-13,AR,2654,290053,3628,65850,6282,355903
3697,2021-01-13,AR,504,396091,0,84,70887,0,0,2021-01-13,AR,56,53126,393,34532,449,87658
3698,2021-01-13,AR,504,396091,0,84,70887,0,0,2021-01-13,AR,2155,26220,0,6,2155,26226
3699,2021-01-13,AR,468,409694,0,58,73028,0,0,2021-01-13,AR,7128,5358310,16603,4490217,23731,9848527
3700,2021-01-13,AR,468,409694,0,58,73028,0,0,2021-01-13,AR,5297,5155152,9007,3956411,14304,9111563
3701,2021-01-13,AR,468,409694,0,58,73028,0,0,2021-01-13,AR,35490,4396978,16404,3500317,51894,7897295
3702,2021-01-13,AR,468,409694,0,58,73028,0,0,2021-01-13,AR,7015,4137738,35420,2722026,42435,6859764
3703,2021-01-13,AR,468,409694,0,58,73028,0,0,2021-01-13,AR,9883,3858444,49144,1494907,59027,5353351
3704,2021-01-13,AR,468,409694,0,58,73028,0,0,2021-01-13,AR,50881,2999650,3871,741563,54752,3741213
3705,2021-01-13,AR,468,409694,0,58,73028,0,0,2021-01-13,AR,5689,1910376,6469,489067,12158,2399443
3706,2021-01-13,AR,468,409694,0,58,73028,0,0,2021-01-13,AR,5200,1174106,21319,268010,26519,1442116
3707,2021-01-13,AR,468,409694,0,58,73028,0,0,2021-01-13,AR,22969,757905,3399,110968,26368,868873
3708,2021-01-13,AR,468,409694,0,58,73028,0,0,2021-01-13,AR,2654,290053,3628,65850,6282,355903
3709,2021-01-13,AR,468,409694,0,58,73028,0,0,2021-01-13,AR,56,53126,393,34532,449,87658
3710,2021-01-13,AR,468,409694,0,58,73028,0,0,2021-01-13,AR,2155,26220,0,6,2155,26226
3711,2021-01-13,AR,327,418147,0,41,74048,0,0,2021-01-13,AR,7128,5358310,16603,4490217,23731,9848527
3712,2021-01-13,AR,327,418147,0,41,74048,0,0,2021-01-13,AR,5297,5155152,9007,3956411,14304,9111563
3713,2021-01-13,AR,327,418147,0,41,74048,0,0,2021-01-13,AR,35490,4396978,16404,3500317,51894,7897295
3714,2021-01-13,AR,327,418147,0,41,74048,0,0,2021-01-13,AR,7015,4137738,35420,2722026,42435,6859764
3715,2021-01-13,AR,327,418147,0,41,74048,0,0,2021-01-13,AR,9883,3858444,49144,1494907,59027,5353351
3716,2021-01-13,AR,327,418147,0,41,74048,0,0,2021-01-13,AR,50881,2999650,3871,741563,54752,3741213
3717,2021-01-13,AR,327,418147,0,41,74048,0,0,2021-01-13,AR,5689,1910376,6469,489067,12158,2399443
3718,2021-01-13,AR,327,418147,0,41,74048,0,0,2021-01-13,AR,5200,1174106,21319,268010,26519,1442116
3719,2021-01-13,AR,327,418147,0,41,74048,0,0,2021-01-13,AR,22969,757905,3399,110968,26368,868873
3720,2021-01-13,AR,327,418147,0,41,74048,0,0,2021-01-13,AR,2654,290053,3628,65850,6282,355903
3721,2021-01-13,AR,327,418147,0,41,74048,0,0,2021-01-13,AR,56,53126,393,34532,449,87658
3722,2021-01-13,AR,327,418147,0,41,74048,0,0,2021-01-13,AR,2155,26220,0,6,2155,26226
3723,2021-01-13,AR,195,425624,0,23,74921,0,0,2021-01-13,AR,7128,5358310,16603,4490217,23731,9848527
3724,2021-01-13,AR,195,425624,0,23,74921,0,0,2021-01-13,AR,5297,5155152,9007,3956411,14304,9111563
3725,2021-01-13,AR,195,425624,0,23,74921,0,0,2021-01-13,AR,35490,4396978,16404,3500317,51894,7897295
3726,2021-01-13,AR,195,425624,0,23,74921,0,0,2021-01-13,AR,7015,4137738,35420,2722026,42435,6859764
3727,2021-01-13,AR,195,425624,0,23,74921,0,0,2021-01-13,AR,9883,3858444,49144,1494907,59027,5353351
3728,2021-01-13,AR,195,425624,0,23,74921,0,0,2021-01-13,AR,50881,2999650,3871,741563,54752,3741213
3729,2021-01-13,AR,195,425624,0,23,74921,0,0,2021-01-13,AR,5689,1910376,6469,489067,12158,2399443
3730,2021-01-13,AR,195,425624,0,23,74921,0,0,2021-01-13,AR,5200,1174106,21319,268010,26519,1442116
3731,2021-01-13,AR,195,425624,0,23,74921,0,0,2021-01-13,AR,22969,757905,3399,110968,26368,868873
3732,2021-01-13,AR,195,425624,0,23,74921,0,0,2021-01-13,AR,2654,290053,3628,65850,6282,355903
3733,2021-01-13,AR,195,425624,0,23,74921,0,0,2021-01-13,AR,56,53126,393,34532,449,87658
3734,2021-01-13,AR,195,425624,0,23,74921,0,0,2021-01-13,AR,2155,26220,0,6,2155,26226
3735,2021-01-13,AR,263,432211,0,39,75802,0,0,2021-01-13,AR,7128,5358310,16603,4490217,23731,9848527
3736,2021-01-13,AR,263,432211,0,39,75802,0,0,2021-01-13,AR,5297,5155152,9007,3956411,14304,9111563
3737,2021-01-13,AR,263,432211,0,39,75802,0,0,2021-01-13,AR,35490,4396978,16404,3500317,51894,7897295
3738,2021-01-13,AR,263,432211,0,39,75802,0,0,2021-01-13,AR,7015,4137738,35420,2722026,42435,6859764
3739,2021-01-13,AR,263,432211,0,39,75802,0,0,2021-01-13,AR,9883,3858444,49144,1494907,59027,5353351
3740,2021-01-13,AR,263,432211,0,39,75802,0,0,2021-01-13,AR,50881,2999650,3871,741563,54752,3741213
3741,2021-01-13,AR,263,432211,0,39,75802,0,0,2021-01-13,AR,5689,1910376,6469,489067,12158,2399443
3742,2021-01-13,AR,263,432211,0,39,75802,0,0,2021-01-13,AR,5200,1174106,21319,268010,26519,1442116
3743,2021-01-13,AR,263,432211,0,39,75802,0,0,2021-01-13,AR,22969,757905,3399,110968,26368,868873
3744,2021-01-13,AR,263,432211,0,39,75802,0,0,2021-01-13,AR,2654,290053,3628,65850,6282,355903
3745,2021-01-13,AR,263,432211,0,39,75802,0,0,2021-01-13,AR,56,53126,393,34532,449,87658
3746,2021-01-13,AR,263,432211,0,39,75802,0,0,2021-01-13,AR,2155,26220,0,6,2155,26226
3747,2021-01-17,AR,486,243245,0,87,39076,0,0,2021-01-17,AR,6297,5386311,12908,4551909,19205,9938220
3748,2021-01-17,AR,486,243245,0,87,39076,0,0,2021-01-17,AR,8599,5179922,30702,4048378,39301,9228300
3749,2021-01-17,AR,486,243245,0,87,39076,0,0,2021-01-17,AR,7414,4497938,7494,3569758,14908,8067696
3750,2021-01-17,AR,486,243245,0,87,39076,0,0,2021-01-17,AR,6779,4161140,44770,2884173,51549,7045313
3751,2021-01-17,AR,486,243245,0,87,39076,0,0,2021-01-17,AR,16454,3890826,46023,1611301,62477,5502127
3752,2021-01-17,AR,486,243245,0,87,39076,0,0,2021-01-17,AR,32769,3183145,12876,779885,45645,3963030
3753,2021-01-17,AR,486,243245,0,87,39076,0,0,2021-01-17,AR,35483,2023523,9200,533112,44683,2556635
3754,2021-01-17,AR,486,243245,0,87,39076,0,0,2021-01-17,AR,12556,1201247,13303,315429,25859,1516676
3755,2021-01-17,AR,486,243245,0,87,39076,0,0,2021-01-17,AR,5860,822324,752,117712,6612,940036
3756,2021-01-17,AR,486,243245,0,87,39076,0,0,2021-01-17,AR,17032,338742,2529,75508,19561,414250
3757,2021-01-17,AR,486,243245,0,87,39076,0,0,2021-01-17,AR,2528,55914,712,35320,3240,91234
3758,2021-01-17,AR,486,243245,0,87,39076,0,0,2021-01-17,AR,143,31886,1,9,144,31895
3759,2021-01-17,AR,454,258454,0,81,42143,0,0,2021-01-17,AR,6297,5386311,12908,4551909,19205,9938220
3760,2021-01-17,AR,454,258454,0,81,42143,0,0,2021-01-17,AR,8599,5179922,30702,4048378,39301,9228300
3761,2021-01-17,AR,454,258454,0,81,42143,0,0,2021-01-17,AR,7414,4497938,7494,3569758,14908,8067696
3762,2021-01-17,AR,454,258454,0,81,42143,0,0,2021-01-17,AR,6779,4161140,44770,2884173,51549,7045313
3763,2021-01-17,AR,454,258454,0,81,42143,0,0,2021-01-17,AR,16454,3890826,46023,1611301,62477,5502127
3764,2021-01-17,AR,454,258454,0,81,42143,0,0,2021-01-17,AR,32769,3183145,12876,779885,45645,3963030
3765,2021-01-17,AR,454,258454,0,81,42143,0,0,2021-01-17,AR,35483,2023523,9200,533112,44683,2556635
3766,2021-01-17,AR,454,258454,0,81,42143,0,0,2021-01-17,AR,12556,1201247,13303,315429,25859,1516676
3767,2021-01-17,AR,454,258454,0,81,42143,0,0,2021-01-17,AR,5860,822324,752,117712,6612,940036
3768,2021-01-17,AR,454,258454,0,81,42143,0,0,2021-01-17,AR,17032,338742,2529,75508,19561,414250
3769,2021-01-17,AR,454,258454,0,81,42143,0,0,2021-01-17,AR,2528,55914,712,35320,3240,91234
3770,2021-01-17,AR,454,258454,0,81,42143,0,0,2021-01-17,AR,143,31886,1,9,144,31895
3771,2021-01-17,AR,502,271148,0,100,44572,0,0,2021-01-17,AR,6297,5386311,12908,4551909,19205,9938220
3772,2021-01-17,AR,502,271148,0,100,44572,0,0,2021-01-17,AR,8599,5179922,30702,4048378,39301,9228300
3773,2021-01-17,AR,502,271148,0,100,44572,0,0,2021-01-17,AR,7414,4497938,7494,3569758,14908,8067696
3774,2021-01-17,AR,502,271148,0,100,44572,0,0,2021-01-17,AR,6779,4161140,44770,2884173,51549,7045313
3775,2021-01-17,AR,502,271148,0,100,44572,0,0,2021-01-17,AR,16454,3890826,46023,1611301,62477,5502127
3776,2021-01-17,AR,502,271148,0,100,44572,0,0,2021-01-17,AR,32769,3183145,12876,779885,45645,3963030
3777,2021-01-17,AR,502,271148,0,100,44572,0,0,2021-01-17,AR,35483,2023523,9200,533112,44683,2556635
3778,2021-01-17,AR,502,271148,0,100,44572,0,0,2021-01-17,AR,12556,1201247,13303,315429,25859,1516676
3779,2021-01-17,AR,502,271148,0,100,44572,0,0,2021-01-17,AR,5860,822324,752,117712,6612,940036
3780,2021-01-17,AR,502,271148,0,100,44572,0,0,2021-01-17,AR,17032,338742,2529,75508,19561,414250
3781,2021-01-17,AR,502,271148,0,100,44572,0,0,2021-01-17,AR,2528,55914,712,35320,3240,91234
3782,2021-01-17,AR,502,271148,0,100,44572,0,0,2021-01-17,AR,143,31886,1,9,144,31895
3783,2021-01-17,AR,846,291709,0,185,48761,0,0,2021-01-17,AR,6297,5386311,12908,4551909,19205,9938220
3784,2021-01-17,AR,846,291709,0,185,48761,0,0,2021-01-17,AR,8599,5179922,30702,4048378,39301,9228300
3785,2021-01-17,AR,846,291709,0,185,48761,0,0,2021-01-17,AR,7414,4497938,7494,3569758,14908,8067696
3786,2021-01-17,AR,846,291709,0,185,48761,0,0,2021-01-17,AR,6779,4161140,44770,2884173,51549,7045313
3787,2021-01-17,AR,846,291709,0,185,48761,0,0,2021-01-17,AR,16454,3890826,46023,1611301,62477,5502127
3788,2021-01-17,AR,846,291709,0,185,48761,0,0,2021-01-17,AR,32769,3183145,12876,779885,45645,3963030
3789,2021-01-17,AR,846,291709,0,185,48761,0,0,2021-01-17,AR,35483,2023523,9200,533112,44683,2556635
3790,2021-01-17,AR,846,291709,0,185,48761,0,0,2021-01-17,AR,12556,1201247,13303,315429,25859,1516676
3791,2021-01-17,AR,846,291709,0,185,48761,0,0,2021-01-17,AR,5860,822324,752,117712,6612,940036
3792,2021-01-17,AR,846,291709,0,185,48761,0,0,2021-01-17,AR,17032,338742,2529,75508,19561,414250
3793,2021-01-17,AR,846,291709,0,185,48761,0,0,2021-01-17,AR,2528,55914,712,35320,3240,91234
3794,2021-01-17,AR,846,291709,0,185,48761,0,0,2021-01-17,AR,143,31886,1,9,144,31895
3795,2021-01-17,AR,1195,319819,0,221,54891,0,0,2021-01-17,AR,6297,5386311,12908,4551909,19205,9938220
3796,2021-01-17,AR,1195,319819,0,221,54891,0,0,2021-01-17,AR,8599,5179922,30702,4048378,39301,9228300
3797,2021-01-17,AR,1195,319819,0,221,54891,0,0,2021-01-17,AR,7414,4497938,7494,3569758,14908,8067696
3798,2021-01-17,AR,1195,319819,0,221,54891,0,0,2021-01-17,AR,6779,4161140,44770,2884173,51549,7045313
3799,2021-01-17,AR,1195,319819,0,221,54891,0,0,2021-01-17,AR,16454,3890826,46023,1611301,62477,5502127
3800,2021-01-17,AR,1195,319819,0,221,54891,0,0,2021-01-17,AR,32769,3183145,12876,779885,45645,3963030
3801,2021-01-17,AR,1195,319819,0,221,54891,0,0,2021-01-17,AR,35483,2023523,9200,533112,44683,2556635
3802,2021-01-17,AR,1195,319819,0,221,54891,0,0,2021-01-17,AR,12556,1201247,13303,315429,25859,1516676
3803,2021-01-17,AR,1195,319819,0,221,54891,0,0,2021-01-17,AR,5860,822324,752,117712,6612,940036
3804,2021-01-17,AR,1195,319819,0,221,54891,0,0,2021-01-17,AR,17032,338742,2529,75508,19561,414250
3805,2021-01-17,AR,1195,319819,0,221,54891,0,0,2021-01-17,AR,2528,55914,712,35320,3240,91234
3806,2021-01-17,AR,1195,319819,0,221,54891,0,0,2021-01-17,AR,143,31886,1,9,144,31895
3807,2021-01-17,AR,916,354470,0,209,62657,0,0,2021-01-17,AR,6297,5386311,12908,4551909,19205,9938220
3808,2021-01-17,AR,916,354470,0,209,62657,0,0,2021-01-17,AR,8599,5179922,30702,4048378,39301,9228300
3809,2021-01-17,AR,916,354470,0,209,62657,0,0,2021-01-17,AR,7414,4497938,7494,3569758,14908,8067696
3810,2021-01-17,AR,916,354470,0,209,62657,0,0,2021-01-17,AR,6779,4161140,44770,2884173,51549,7045313
3811,2021-01-17,AR,916,354470,0,209,62657,0,0,2021-01-17,AR,16454,3890826,46023,1611301,62477,5502127
3812,2021-01-17,AR,916,354470,0,209,62657,0,0,2021-01-17,AR,32769,3183145,12876,779885,45645,3963030
3813,2021-01-17,AR,916,354470,0,209,62657,0,0,2021-01-17,AR,35483,2023523,9200,533112,44683,2556635
3814,2021-01-17,AR,916,354470,0,209,62657,0,0,2021-01-17,AR,12556,1201247,13303,315429,25859,1516676
3815,2021-01-17,AR,916,354470,0,209,62657,0,0,2021-01-17,AR,5860,822324,752,117712,6612,940036
3816,2021-01-17,AR,916,354470,0,209,62657,0,0,2021-01-17,AR,17032,338742,2529,75508,19561,414250
3817,2021-01-17,AR,916,354470,0,209,62657,0,0,2021-01-17,AR,2528,55914,712,35320,3240,91234
3818,2021-01-17,AR,916,354470,0,209,62657,0,0,2021-01-17,AR,143,31886,1,9,144,31895
3819,2021-01-17,AR,624,379078,0,141,67723,0,0,2021-01-17,AR,6297,5386311,12908,4551909,19205,9938220
3820,2021-01-17,AR,624,379078,0,141,67723,0,0,2021-01-17,AR,8599,5179922,30702,4048378,39301,9228300
3821,2021-01-17,AR,624,379078,0,141,67723,0,0,2021-01-17,AR,7414,4497938,7494,3569758,14908,8067696
3822,2021-01-17,AR,624,379078,0,141,67723,0,0,2021-01-17,AR,6779,4161140,44770,2884173,51549,7045313
3823,2021-01-17,AR,624,379078,0,141,67723,0,0,2021-01-17,AR,16454,3890826,46023,1611301,62477,5502127
3824,2021-01-17,AR,624,379078,0,141,67723,0,0,2021-01-17,AR,32769,3183145,12876,779885,45645,3963030
3825,2021-01-17,AR,624,379078,0,141,67723,0,0,2021-01-17,AR,35483,2023523,9200,533112,44683,2556635
3826,2021-01-17,AR,624,379078,0,141,67723,0,0,2021-01-17,AR,12556,1201247,13303,315429,25859,1516676
3827,2021-01-17,AR,624,379078,0,141,67723,0,0,2021-01-17,AR,5860,822324,752,117712,6612,940036
3828,2021-01-17,AR,624,379078,0,141,67723,0,0,2021-01-17,AR,17032,338742,2529,75508,19561,414250
3829,2021-01-17,AR,624,379078,0,141,67723,0,0,2021-01-17,AR,2528,55914,712,35320,3240,91234
3830,2021-01-17,AR,624,379078,0,141,67723,0,0,2021-01-17,AR,143,31886,1,9,144,31895
3831,2021-01-17,AR,621,398089,0,89,71256,0,0,2021-01-17,AR,6297,5386311,12908,4551909,19205,9938220
3832,2021-01-17,AR,621,398089,0,89,71256,0,0,2021-01-17,AR,8599,5179922,30702,4048378,39301,9228300
3833,2021-01-17,AR,621,398089,0,89,71256,0,0,2021-01-17,AR,7414,4497938,7494,3569758,14908,8067696
3834,2021-01-17,AR,621,398089,0,89,71256,0,0,2021-01-17,AR,6779,4161140,44770,2884173,51549,7045313
3835,2021-01-17,AR,621,398089,0,89,71256,0,0,2021-01-17,AR,16454,3890826,46023,1611301,62477,5502127
3836,2021-01-17,AR,621,398089,0,89,71256,0,0,2021-01-17,AR,32769,3183145,12876,779885,45645,3963030
3837,2021-01-17,AR,621,398089,0,89,71256,0,0,2021-01-17,AR,35483,2023523,9200,533112,44683,2556635
3838,2021-01-17,AR,621,398089,0,89,71256,0,0,2021-01-17,AR,12556,1201247,13303,315429,25859,1516676
3839,2021-01-17,AR,621,398089,0,89,71256,0,0,2021-01-17,AR,5860,822324,752,117712,6612,940036
3840,2021-01-17,AR,621,398089,0,89,71256,0,0,2021-01-17,AR,17032,338742,2529,75508,19561,414250
3841,2021-01-17,AR,621,398089,0,89,71256,0,0,2021-01-17,AR,2528,55914,712,35320,3240,91234
3842,2021-01-17,AR,621,398089,0,89,71256,0,0,2021-01-17,AR,143,31886,1,9,144,31895
3843,2021-01-17,AR,344,411048,0,40,73190,0,0,2021-01-17,AR,6297,5386311,12908,4551909,19205,9938220
3844,2021-01-17,AR,344,411048,0,40,73190,0,0,2021-01-17,AR,8599,5179922,30702,4048378,39301,9228300
3845,2021-01-17,AR,344,411048,0,40,73190,0,0,2021-01-17,AR,7414,4497938,7494,3569758,14908,8067696
3846,2021-01-17,AR,344,411048,0,40,73190,0,0,2021-01-17,AR,6779,4161140,44770,2884173,51549,7045313
3847,2021-01-17,AR,344,411048,0,40,73190,0,0,2021-01-17,AR,16454,3890826,46023,1611301,62477,5502127
3848,2021-01-17,AR,344,411048,0,40,73190,0,0,2021-01-17,AR,32769,3183145,12876,779885,45645,3963030
3849,2021-01-17,AR,344,411048,0,40,73190,0,0,2021-01-17,AR,35483,2023523,9200,533112,44683,2556635
3850,2021-01-17,AR,344,411048,0,40,73190,0,0,2021-01-17,AR,12556,1201247,13303,315429,25859,1516676
3851,2021-01-17,AR,344,411048,0,40,73190,0,0,2021-01-17,AR,5860,822324,752,117712,6612,940036
3852,2021-01-17,AR,344,411048,0,40,73190,0,0,2021-01-17,AR,17032,338742,2529,75508,19561,414250
3853,2021-01-17,AR,344,411048,0,40,73190,0,0,2021-01-17,AR,2528,55914,712,35320,3240,91234
3854,2021-01-17,AR,344,411048,0,40,73190,0,0,2021-01-17,AR,143,31886,1,9,144,31895
3855,2021-01-17,AR,212,419068,0,19,74145,0,0,2021-01-17,AR,6297,5386311,12908,4551909,19205,9938220
3856,2021-01-17,AR,212,419068,0,19,74145,0,0,2021-01-17,AR,8599,5179922,30702,4048378,39301,9228300
3857,2021-01-17,AR,212,419068,0,19,74145,0,0,2021-01-17,AR,7414,4497938,7494,3569758,14908,8067696
3858,2021-01-17,AR,212,419068,0,19,74145,0,0,2021-01-17,AR,6779,4161140,44770,2884173,51549,7045313
3859,2021-01-17,AR,212,419068,0,19,74145,0,0,2021-01-17,AR,16454,3890826,46023,1611301,62477,5502127
3860,2021-01-17,AR,212,419068,0,19,74145,0,0,2021-01-17,AR,32769,3183145,12876,779885,45645,3963030
3861,2021-01-17,AR,212,419068,0,19,74145,0,0,2021-01-17,AR,35483,2023523,9200,533112,44683,2556635
3862,2021-01-17,AR,212,419068,0,19,74145,0,0,2021-01-17,AR,12556,1201247,13303,315429,25859,1516676
3863,2021-01-17,AR,212,419068,0,19,74145,0,0,2021-01-17,AR,5860,822324,752,117712,6612,940036
3864,2021-01-17,AR,212,419068,0,19,74145,0,0,2021-01-17,AR,17032,338742,2529,75508,19561,414250
3865,2021-01-17,AR,212,419068,0,19,74145,0,0,2021-01-17,AR,2528,55914,712,35320,3240,91234
3866,2021-01-17,AR,212,419068,0,19,74145,0,0,2021-01-17,AR,143,31886,1,9,144,31895
3867,2021-01-17,AR,229,426569,0,31,75036,0,0,2021-01-17,AR,6297,5386311,12908,4551909,19205,9938220
3868,2021-01-17,AR,229,426569,0,31,75036,0,0,2021-01-17,AR,8599,5179922,30702,4048378,39301,9228300
3869,2021-01-17,AR,229,426569,0,31,75036,0,0,2021-01-17,AR,7414,4497938,7494,3569758,14908,8067696
3870,2021-01-17,AR,229,426569,0,31,75036,0,0,2021-01-17,AR,6779,4161140,44770,2884173,51549,7045313
3871,2021-01-17,AR,229,426569,0,31,75036,0,0,2021-01-17,AR,16454,3890826,46023,1611301,62477,5502127
3872,2021-01-17,AR,229,426569,0,31,75036,0,0,2021-01-17,AR,32769,3183145,12876,779885,45645,3963030
3873,2021-01-17,AR,229,426569,0,31,75036,0,0,2021-01-17,AR,35483,2023523,9200,533112,44683,2556635
3874,2021-01-17,AR,229,426569,0,31,75036,0,0,2021-01-17,AR,12556,1201247,13303,315429,25859,1516676
3875,2021-01-17,AR,229,426569,0,31,75036,0,0,2021-01-17,AR,5860,822324,752,117712,6612,940036
3876,2021-01-17,AR,229,426569,0,31,75036,0,0,2021-01-17,AR,17032,338742,2529,75508,19561,414250
3877,2021-01-17,AR,229,426569,0,31,75036,0,0,2021-01-17,AR,2528,55914,712,35320,3240,91234
3878,2021-01-17,AR,229,426569,0,31,75036,0,0,2021-01-17,AR,143,31886,1,9,144,31895
3879,2021-01-17,AR,184,433113,0,38,75971,0,0,2021-01-17,AR,6297,5386311,12908,4551909,19205,9938220
3880,2021-01-17,AR,184,433113,0,38,75971,0,0,2021-01-17,AR,8599,5179922,30702,4048378,39301,9228300
3881,2021-01-17,AR,184,433113,0,38,75971,0,0,2021-01-17,AR,7414,4497938,7494,3569758,14908,8067696
3882,2021-01-17,AR,184,433113,0,38,75971,0,0,2021-01-17,AR,6779,4161140,44770,2884173,51549,7045313
3883,2021-01-17,AR,184,433113,0,38,75971,0,0,2021-01-17,AR,16454,3890826,46023,1611301,62477,5502127
3884,2021-01-17,AR,184,433113,0,38,75971,0,0,2021-01-17,AR,32769,3183145,12876,779885,45645,3963030
3885,2021-01-17,AR,184,433113,0,38,75971,0,0,2021-01-17,AR,35483,2023523,9200,533112,44683,2556635
3886,2021-01-17,AR,184,433113,0,38,75971,0,0,2021-01-17,AR,12556,1201247,13303,315429,25859,1516676
3887,2021-01-17,AR,184,433113,0,38,75971,0,0,2021-01-17,AR,5860,822324,752,117712,6612,940036
3888,2021-01-17,AR,184,433113,0,38,75971,0,0,2021-01-17,AR,17032,338742,2529,75508,19561,414250
3889,2021-01-17,AR,184,433113,0,38,75971,0,0,2021-01-17,AR,2528,55914,712,35320,3240,91234
3890,2021-01-17,AR,184,433113,0,38,75971,0,0,2021-01-17,AR,143,31886,1,9,144,31895
3891,2021-01-20,AR,606,245004,0,130,39422,0,0,2021-01-20,AR,6364,5397222,13505,4577161,19869,9974383
3892,2021-01-20,AR,606,245004,0,130,39422,0,0,2021-01-20,AR,5035,5201928,12079,4122988,17114,9324916
3893,2021-01-20,AR,606,245004,0,130,39422,0,0,2021-01-20,AR,43750,4626028,13364,3615568,57114,8241596
3894,2021-01-20,AR,606,245004,0,130,39422,0,0,2021-01-20,AR,6746,4175591,44364,2974683,51110,7150274
3895,2021-01-20,AR,606,245004,0,130,39422,0,0,2021-01-20,AR,17074,3939951,43573,1745564,60647,5685515
3896,2021-01-20,AR,606,245004,0,130,39422,0,0,2021-01-20,AR,33660,3284021,29674,826091,63334,4110112
3897,2021-01-20,AR,606,245004,0,130,39422,0,0,2021-01-20,AR,14799,2119241,646,543502,15445,2662743
3898,2021-01-20,AR,606,245004,0,130,39422,0,0,2021-01-20,AR,19878,1261502,5900,332533,25778,1594035
3899,2021-01-20,AR,606,245004,0,130,39422,0,0,2021-01-20,AR,15826,852227,2023,121847,17849,974074
3900,2021-01-20,AR,606,245004,0,130,39422,0,0,2021-01-20,AR,5444,370015,1769,88278,7213,458293
3901,2021-01-20,AR,606,245004,0,130,39422,0,0,2021-01-20,AR,4286,75619,196,38073,4482,113692
3902,2021-01-20,AR,606,245004,0,130,39422,0,0,2021-01-20,AR,849,35319,1936,2689,2785,38008
3903,2021-01-28,AR,501,249330,0,108,40324,0,0,2021-01-28,AR,9912,5438768,16785,4657285,26697,10096053
3904,2021-01-28,AR,501,249330,0,108,40324,0,0,2021-01-28,AR,2258,5251417,7392,4251652,9650,9503069
3905,2021-01-28,AR,501,249330,0,108,40324,0,0,2021-01-28,AR,32075,4891322,15768,3729686,47843,8621008
3906,2021-01-28,AR,501,249330,0,108,40324,0,0,2021-01-28,AR,8356,4245716,32809,3185900,41165,7431616
3907,2021-01-28,AR,501,249330,0,108,40324,0,0,2021-01-28,AR,6165,4021156,28098,2073032,34263,6094188
3908,2021-01-28,AR,501,249330,0,108,40324,0,0,2021-01-28,AR,35012,3564594,29981,956068,64993,4520662
3909,2021-01-28,AR,501,249330,0,108,40324,0,0,2021-01-28,AR,44899,2391636,7617,592145,52516,2983781
3910,2021-01-28,AR,501,249330,0,108,40324,0,0,2021-01-28,AR,17051,1343520,16537,397447,33588,1740967
3911,2021-01-28,AR,501,249330,0,108,40324,0,0,2021-01-28,AR,19686,1008117,3084,132258,22770,1140375
3912,2021-01-28,AR,501,249330,0,108,40324,0,0,2021-01-28,AR,3178,438735,4,96548,3182,535283
3913,2021-01-28,AR,501,249330,0,108,40324,0,0,2021-01-28,AR,593,133544,50,42961,643,176505
3914,2021-01-28,AR,501,249330,0,108,40324,0,0,2021-01-28,AR,229,39475,2062,9958,2291,49433
3915,2021-01-20,AR,334,259692,0,74,42408,0,0,2021-01-20,AR,6364,5397222,13505,4577161,19869,9974383
3916,2021-01-20,AR,334,259692,0,74,42408,0,0,2021-01-20,AR,5035,5201928,12079,4122988,17114,9324916
3917,2021-01-20,AR,334,259692,0,74,42408,0,0,2021-01-20,AR,43750,4626028,13364,3615568,57114,8241596
3918,2021-01-20,AR,334,259692,0,74,42408,0,0,2021-01-20,AR,6746,4175591,44364,2974683,51110,7150274
3919,2021-01-20,AR,334,259692,0,74,42408,0,0,2021-01-20,AR,17074,3939951,43573,1745564,60647,5685515
3920,2021-01-20,AR,334,259692,0,74,42408,0,0,2021-01-20,AR,33660,3284021,29674,826091,63334,4110112
3921,2021-01-20,AR,334,259692,0,74,42408,0,0,2021-01-20,AR,14799,2119241,646,543502,15445,2662743
3922,2021-01-20,AR,334,259692,0,74,42408,0,0,2021-01-20,AR,19878,1261502,5900,332533,25778,1594035
3923,2021-01-20,AR,334,259692,0,74,42408,0,0,2021-01-20,AR,15826,852227,2023,121847,17849,974074
3924,2021-01-20,AR,334,259692,0,74,42408,0,0,2021-01-20,AR,5444,370015,1769,88278,7213,458293
3925,2021-01-20,AR,334,259692,0,74,42408,0,0,2021-01-20,AR,4286,75619,196,38073,4482,113692
3926,2021-01-20,AR,334,259692,0,74,42408,0,0,2021-01-20,AR,849,35319,1936,2689,2785,38008
3927,2021-01-28,AR,411,263170,0,67,43041,0,0,2021-01-28,AR,9912,5438768,16785,4657285,26697,10096053
3928,2021-01-28,AR,411,263170,0,67,43041,0,0,2021-01-28,AR,2258,5251417,7392,4251652,9650,9503069
3929,2021-01-28,AR,411,263170,0,67,43041,0,0,2021-01-28,AR,32075,4891322,15768,3729686,47843,8621008
3930,2021-01-28,AR,411,263170,0,67,43041,0,0,2021-01-28,AR,8356,4245716,32809,3185900,41165,7431616
3931,2021-01-28,AR,411,263170,0,67,43041,0,0,2021-01-28,AR,6165,4021156,28098,2073032,34263,6094188
3932,2021-01-28,AR,411,263170,0,67,43041,0,0,2021-01-28,AR,35012,3564594,29981,956068,64993,4520662
3933,2021-01-28,AR,411,263170,0,67,43041,0,0,2021-01-28,AR,44899,2391636,7617,592145,52516,2983781
3934,2021-01-28,AR,411,263170,0,67,43041,0,0,2021-01-28,AR,17051,1343520,16537,397447,33588,1740967
3935,2021-01-28,AR,411,263170,0,67,43041,0,0,2021-01-28,AR,19686,1008117,3084,132258,22770,1140375
3936,2021-01-28,AR,411,263170,0,67,43041,0,0,2021-01-28,AR,3178,438735,4,96548,3182,535283
3937,2021-01-28,AR,411,263170,0,67,43041,0,0,2021-01-28,AR,593,133544,50,42961,643,176505
3938,2021-01-28,AR,411,263170,0,67,43041,0,0,2021-01-28,AR,229,39475,2062,9958,2291,49433
3939,2021-01-20,AR,416,272538,0,88,44845,0,0,2021-01-20,AR,6364,5397222,13505,4577161,19869,9974383
3940,2021-01-20,AR,416,272538,0,88,44845,0,0,2021-01-20,AR,5035,5201928,12079,4122988,17114,9324916
3941,2021-01-20,AR,416,272538,0,88,44845,0,0,2021-01-20,AR,43750,4626028,13364,3615568,57114,8241596
3942,2021-01-20,AR,416,272538,0,88,44845,0,0,2021-01-20,AR,6746,4175591,44364,2974683,51110,7150274
3943,2021-01-20,AR,416,272538,0,88,44845,0,0,2021-01-20,AR,17074,3939951,43573,1745564,60647,5685515
3944,2021-01-20,AR,416,272538,0,88,44845,0,0,2021-01-20,AR,33660,3284021,29674,826091,63334,4110112
3945,2021-01-20,AR,416,272538,0,88,44845,0,0,2021-01-20,AR,14799,2119241,646,543502,15445,2662743
3946,2021-01-20,AR,416,272538,0,88,44845,0,0,2021-01-20,AR,19878,1261502,5900,332533,25778,1594035
3947,2021-01-20,AR,416,272538,0,88,44845,0,0,2021-01-20,AR,15826,852227,2023,121847,17849,974074
3948,2021-01-20,AR,416,272538,0,88,44845,0,0,2021-01-20,AR,5444,370015,1769,88278,7213,458293
3949,2021-01-20,AR,416,272538,0,88,44845,0,0,2021-01-20,AR,4286,75619,196,38073,4482,113692
3950,2021-01-20,AR,416,272538,0,88,44845,0,0,2021-01-20,AR,849,35319,1936,2689,2785,38008
3951,2021-01-28,AR,493,276575,0,93,45660,0,0,2021-01-28,AR,9912,5438768,16785,4657285,26697,10096053
3952,2021-01-28,AR,493,276575,0,93,45660,0,0,2021-01-28,AR,2258,5251417,7392,4251652,9650,9503069
3953,2021-01-28,AR,493,276575,0,93,45660,0,0,2021-01-28,AR,32075,4891322,15768,3729686,47843,8621008
3954,2021-01-28,AR,493,276575,0,93,45660,0,0,2021-01-28,AR,8356,4245716,32809,3185900,41165,7431616
3955,2021-01-28,AR,493,276575,0,93,45660,0,0,2021-01-28,AR,6165,4021156,28098,2073032,34263,6094188
3956,2021-01-28,AR,493,276575,0,93,45660,0,0,2021-01-28,AR,35012,3564594,29981,956068,64993,4520662
3957,2021-01-28,AR,493,276575,0,93,45660,0,0,2021-01-28,AR,44899,2391636,7617,592145,52516,2983781
3958,2021-01-28,AR,493,276575,0,93,45660,0,0,2021-01-28,AR,17051,1343520,16537,397447,33588,1740967
3959,2021-01-28,AR,493,276575,0,93,45660,0,0,2021-01-28,AR,19686,1008117,3084,132258,22770,1140375
3960,2021-01-28,AR,493,276575,0,93,45660,0,0,2021-01-28,AR,3178,438735,4,96548,3182,535283
3961,2021-01-28,AR,493,276575,0,93,45660,0,0,2021-01-28,AR,593,133544,50,42961,643,176505
3962,2021-01-28,AR,493,276575,0,93,45660,0,0,2021-01-28,AR,229,39475,2062,9958,2291,49433
3963,2021-01-20,AR,991,294515,0,212,49366,0,0,2021-01-20,AR,6364,5397222,13505,4577161,19869,9974383
3964,2021-01-20,AR,991,294515,0,212,49366,0,0,2021-01-20,AR,5035,5201928,12079,4122988,17114,9324916
3965,2021-01-20,AR,991,294515,0,212,49366,0,0,2021-01-20,AR,43750,4626028,13364,3615568,57114,8241596
3966,2021-01-20,AR,991,294515,0,212,49366,0,0,2021-01-20,AR,6746,4175591,44364,2974683,51110,7150274
3967,2021-01-20,AR,991,294515,0,212,49366,0,0,2021-01-20,AR,17074,3939951,43573,1745564,60647,5685515
3968,2021-01-20,AR,991,294515,0,212,49366,0,0,2021-01-20,AR,33660,3284021,29674,826091,63334,4110112
3969,2021-01-20,AR,991,294515,0,212,49366,0,0,2021-01-20,AR,14799,2119241,646,543502,15445,2662743
3970,2021-01-20,AR,991,294515,0,212,49366,0,0,2021-01-20,AR,19878,1261502,5900,332533,25778,1594035
3971,2021-01-20,AR,991,294515,0,212,49366,0,0,2021-01-20,AR,15826,852227,2023,121847,17849,974074
3972,2021-01-20,AR,991,294515,0,212,49366,0,0,2021-01-20,AR,5444,370015,1769,88278,7213,458293
3973,2021-01-20,AR,991,294515,0,212,49366,0,0,2021-01-20,AR,4286,75619,196,38073,4482,113692
3974,2021-01-20,AR,991,294515,0,212,49366,0,0,2021-01-20,AR,849,35319,1936,2689,2785,38008
3975,2021-01-28,AR,1023,301977,0,209,50972,0,0,2021-01-28,AR,9912,5438768,16785,4657285,26697,10096053
3976,2021-01-28,AR,1023,301977,0,209,50972,0,0,2021-01-28,AR,2258,5251417,7392,4251652,9650,9503069
3977,2021-01-28,AR,1023,301977,0,209,50972,0,0,2021-01-28,AR,32075,4891322,15768,3729686,47843,8621008
3978,2021-01-28,AR,1023,301977,0,209,50972,0,0,2021-01-28,AR,8356,4245716,32809,3185900,41165,7431616
3979,2021-01-28,AR,1023,301977,0,209,50972,0,0,2021-01-28,AR,6165,4021156,28098,2073032,34263,6094188
3980,2021-01-28,AR,1023,301977,0,209,50972,0,0,2021-01-28,AR,35012,3564594,29981,956068,64993,4520662
3981,2021-01-28,AR,1023,301977,0,209,50972,0,0,2021-01-28,AR,44899,2391636,7617,592145,52516,2983781
3982,2021-01-28,AR,1023,301977,0,209,50972,0,0,2021-01-28,AR,17051,1343520,16537,397447,33588,1740967
3983,2021-01-28,AR,1023,301977,0,209,50972,0,0,2021-01-28,AR,19686,1008117,3084,132258,22770,1140375
3984,2021-01-28,AR,1023,301977,0,209,50972,0,0,2021-01-28,AR,3178,438735,4,96548,3182,535283
3985,2021-01-28,AR,1023,301977,0,209,50972,0,0,2021-01-28,AR,593,133544,50,42961,643,176505
3986,2021-01-28,AR,1023,301977,0,209,50972,0,0,2021-01-28,AR,229,39475,2062,9958,2291,49433
3987,2021-01-20,AR,1222,323421,0,292,55724,0,0,2021-01-20,AR,6364,5397222,13505,4577161,19869,9974383
3988,2021-01-20,AR,1222,323421,0,292,55724,0,0,2021-01-20,AR,5035,5201928,12079,4122988,17114,9324916
3989,2021-01-20,AR,1222,323421,0,292,55724,0,0,2021-01-20,AR,43750,4626028,13364,3615568,57114,8241596
3990,2021-01-20,AR,1222,323421,0,292,55724,0,0,2021-01-20,AR,6746,4175591,44364,2974683,51110,7150274
3991,2021-01-20,AR,1222,323421,0,292,55724,0,0,2021-01-20,AR,17074,3939951,43573,1745564,60647,5685515
3992,2021-01-20,AR,1222,323421,0,292,55724,0,0,2021-01-20,AR,33660,3284021,29674,826091,63334,4110112
3993,2021-01-20,AR,1222,323421,0,292,55724,0,0,2021-01-20,AR,14799,2119241,646,543502,15445,2662743
3994,2021-01-20,AR,1222,323421,0,292,55724,0,0,2021-01-20,AR,19878,1261502,5900,332533,25778,1594035
3995,2021-01-20,AR,1222,323421,0,292,55724,0,0,2021-01-20,AR,15826,852227,2023,121847,17849,974074
3996,2021-01-20,AR,1222,323421,0,292,55724,0,0,2021-01-20,AR,5444,370015,1769,88278,7213,458293
3997,2021-01-20,AR,1222,323421,0,292,55724,0,0,2021-01-20,AR,4286,75619,196,38073,4482,113692
3998,2021-01-20,AR,1222,323421,0,292,55724,0,0,2021-01-20,AR,849,35319,1936,2689,2785,38008
3999,2021-01-28,AR,1287,332732,0,303,57785,0,0,2021-01-28,AR,9912,5438768,16785,4657285,26697,10096053
4000,2021-01-28,AR,1287,332732,0,303,57785,0,0,2021-01-28,AR,2258,5251417,7392,4251652,9650,9503069
4001,2021-01-28,AR,1287,332732,0,303,57785,0,0,2021-01-28,AR,32075,4891322,15768,3729686,47843,8621008
4002,2021-01-28,AR,1287,332732,0,303,57785,0,0,2021-01-28,AR,8356,4245716,32809,3185900,41165,7431616
4003,2021-01-28,AR,1287,332732,0,303,57785,0,0,2021-01-28,AR,6165,4021156,28098,2073032,34263,6094188
4004,2021-01-28,AR,1287,332732,0,303,57785,0,0,2021-01-28,AR,35012,3564594,29981,956068,64993,4520662
4005,2021-01-28,AR,1287,332732,0,303,57785,0,0,2021-01-28,AR,44899,2391636,7617,592145,52516,2983781
4006,2021-01-28,AR,1287,332732,0,303,57785,0,0,2021-01-28,AR,17051,1343520,16537,397447,33588,1740967
4007,2021-01-28,AR,1287,332732,0,303,57785,0,0,2021-01-28,AR,19686,1008117,3084,132258,22770,1140375
4008,2021-01-28,AR,1287,332732,0,303,57785,0,0,2021-01-28,AR,3178,438735,4,96548,3182,535283
4009,2021-01-28,AR,1287,332732,0,303,57785,0,0,2021-01-28,AR,593,133544,50,42961,643,176505
4010,2021-01-28,AR,1287,332732,0,303,57785,0,0,2021-01-28,AR,229,39475,2062,9958,2291,49433
4011,2021-01-20,AR,728,356920,0,192,63224,0,0,2021-01-20,AR,6364,5397222,13505,4577161,19869,9974383
4012,2021-01-20,AR,728,356920,0,192,63224,0,0,2021-01-20,AR,5035,5201928,12079,4122988,17114,9324916
4013,2021-01-20,AR,728,356920,0,192,63224,0,0,2021-01-20,AR,43750,4626028,13364,3615568,57114,8241596
4014,2021-01-20,AR,728,356920,0,192,63224,0,0,2021-01-20,AR,6746,4175591,44364,2974683,51110,7150274
4015,2021-01-20,AR,728,356920,0,192,63224,0,0,2021-01-20,AR,17074,3939951,43573,1745564,60647,5685515
4016,2021-01-20,AR,728,356920,0,192,63224,0,0,2021-01-20,AR,33660,3284021,29674,826091,63334,4110112
4017,2021-01-20,AR,728,356920,0,192,63224,0,0,2021-01-20,AR,14799,2119241,646,543502,15445,2662743
4018,2021-01-20,AR,728,356920,0,192,63224,0,0,2021-01-20,AR,19878,1261502,5900,332533,25778,1594035
4019,2021-01-20,AR,728,356920,0,192,63224,0,0,2021-01-20,AR,15826,852227,2023,121847,17849,974074
4020,2021-01-20,AR,728,356920,0,192,63224,0,0,2021-01-20,AR,5444,370015,1769,88278,7213,458293
4021,2021-01-20,AR,728,356920,0,192,63224,0,0,2021-01-20,AR,4286,75619,196,38073,4482,113692
4022,2021-01-20,AR,728,356920,0,192,63224,0,0,2021-01-20,AR,849,35319,1936,2689,2785,38008
4023,2021-01-28,AR,895,363815,0,203,64697,0,0,2021-01-28,AR,9912,5438768,16785,4657285,26697,10096053
4024,2021-01-28,AR,895,363815,0,203,64697,0,0,2021-01-28,AR,2258,5251417,7392,4251652,9650,9503069
4025,2021-01-28,AR,895,363815,0,203,64697,0,0,2021-01-28,AR,32075,4891322,15768,3729686,47843,8621008
4026,2021-01-28,AR,895,363815,0,203,64697,0,0,2021-01-28,AR,8356,4245716,32809,3185900,41165,7431616
4027,2021-01-28,AR,895,363815,0,203,64697,0,0,2021-01-28,AR,6165,4021156,28098,2073032,34263,6094188
4028,2021-01-28,AR,895,363815,0,203,64697,0,0,2021-01-28,AR,35012,3564594,29981,956068,64993,4520662
4029,2021-01-28,AR,895,363815,0,203,64697,0,0,2021-01-28,AR,44899,2391636,7617,592145,52516,2983781
4030,2021-01-28,AR,895,363815,0,203,64697,0,0,2021-01-28,AR,17051,1343520,16537,397447,33588,1740967
4031,2021-01-28,AR,895,363815,0,203,64697,0,0,2021-01-28,AR,19686,1008117,3084,132258,22770,1140375
4032,2021-01-28,AR,895,363815,0,203,64697,0,0,2021-01-28,AR,3178,438735,4,96548,3182,535283
4033,2021-01-28,AR,895,363815,0,203,64697,0,0,2021-01-28,AR,593,133544,50,42961,643,176505
4034,2021-01-28,AR,895,363815,0,203,64697,0,0,2021-01-28,AR,229,39475,2062,9958,2291,49433
4035,2021-01-20,AR,712,381171,0,145,68145,0,0,2021-01-20,AR,6364,5397222,13505,4577161,19869,9974383
4036,2021-01-20,AR,712,381171,0,145,68145,0,0,2021-01-20,AR,5035,5201928,12079,4122988,17114,9324916
4037,2021-01-20,AR,712,381171,0,145,68145,0,0,2021-01-20,AR,43750,4626028,13364,3615568,57114,8241596
4038,2021-01-20,AR,712,381171,0,145,68145,0,0,2021-01-20,AR,6746,4175591,44364,2974683,51110,7150274
4039,2021-01-20,AR,712,381171,0,145,68145,0,0,2021-01-20,AR,17074,3939951,43573,1745564,60647,5685515
4040,2021-01-20,AR,712,381171,0,145,68145,0,0,2021-01-20,AR,33660,3284021,29674,826091,63334,4110112
4041,2021-01-20,AR,712,381171,0,145,68145,0,0,2021-01-20,AR,14799,2119241,646,543502,15445,2662743
4042,2021-01-20,AR,712,381171,0,145,68145,0,0,2021-01-20,AR,19878,1261502,5900,332533,25778,1594035
4043,2021-01-20,AR,712,381171,0,145,68145,0,0,2021-01-20,AR,15826,852227,2023,121847,17849,974074
4044,2021-01-20,AR,712,381171,0,145,68145,0,0,2021-01-20,AR,5444,370015,1769,88278,7213,458293
4045,2021-01-20,AR,712,381171,0,145,68145,0,0,2021-01-20,AR,4286,75619,196,38073,4482,113692
4046,2021-01-20,AR,712,381171,0,145,68145,0,0,2021-01-20,AR,849,35319,1936,2689,2785,38008
4047,2021-01-28,AR,653,386529,0,107,69122,0,0,2021-01-28,AR,9912,5438768,16785,4657285,26697,10096053
4048,2021-01-28,AR,653,386529,0,107,69122,0,0,2021-01-28,AR,2258,5251417,7392,4251652,9650,9503069
4049,2021-01-28,AR,653,386529,0,107,69122,0,0,2021-01-28,AR,32075,4891322,15768,3729686,47843,8621008
4050,2021-01-28,AR,653,386529,0,107,69122,0,0,2021-01-28,AR,8356,4245716,32809,3185900,41165,7431616
4051,2021-01-28,AR,653,386529,0,107,69122,0,0,2021-01-28,AR,6165,4021156,28098,2073032,34263,6094188
4052,2021-01-28,AR,653,386529,0,107,69122,0,0,2021-01-28,AR,35012,3564594,29981,956068,64993,4520662
4053,2021-01-28,AR,653,386529,0,107,69122,0,0,2021-01-28,AR,44899,2391636,7617,592145,52516,2983781
4054,2021-01-28,AR,653,386529,0,107,69122,0,0,2021-01-28,AR,17051,1343520,16537,397447,33588,1740967
4055,2021-01-28,AR,653,386529,0,107,69122,0,0,2021-01-28,AR,19686,1008117,3084,132258,22770,1140375
4056,2021-01-28,AR,653,386529,0,107,69122,0,0,2021-01-28,AR,3178,438735,4,96548,3182,535283
4057,2021-01-28,AR,653,386529,0,107,69122,0,0,2021-01-28,AR,593,133544,50,42961,643,176505
4058,2021-01-28,AR,653,386529,0,107,69122,0,0,2021-01-28,AR,229,39475,2062,9958,2291,49433
4059,2021-01-20,AR,494,399733,0,80,71537,0,0,2021-01-20,AR,6364,5397222,13505,4577161,19869,9974383
4060,2021-01-20,AR,494,399733,0,80,71537,0,0,2021-01-20,AR,5035,5201928,12079,4122988,17114,9324916
4061,2021-01-20,AR,494,399733,0,80,71537,0,0,2021-01-20,AR,43750,4626028,13364,3615568,57114,8241596
4062,2021-01-20,AR,494,399733,0,80,71537,0,0,2021-01-20,AR,6746,4175591,44364,2974683,51110,7150274
4063,2021-01-20,AR,494,399733,0,80,71537,0,0,2021-01-20,AR,17074,3939951,43573,1745564,60647,5685515
4064,2021-01-20,AR,494,399733,0,80,71537,0,0,2021-01-20,AR,33660,3284021,29674,826091,63334,4110112
4065,2021-01-20,AR,494,399733,0,80,71537,0,0,2021-01-20,AR,14799,2119241,646,543502,15445,2662743
4066,2021-01-20,AR,494,399733,0,80,71537,0,0,2021-01-20,AR,19878,1261502,5900,332533,25778,1594035
4067,2021-01-20,AR,494,399733,0,80,71537,0,0,2021-01-20,AR,15826,852227,2023,121847,17849,974074
4068,2021-01-20,AR,494,399733,0,80,71537,0,0,2021-01-20,AR,5444,370015,1769,88278,7213,458293
4069,2021-01-20,AR,494,399733,0,80,71537,0,0,2021-01-20,AR,4286,75619,196,38073,4482,113692
4070,2021-01-20,AR,494,399733,0,80,71537,0,0,2021-01-20,AR,849,35319,1936,2689,2785,38008
4071,2021-01-28,AR,392,403371,0,69,72120,0,0,2021-01-28,AR,9912,5438768,16785,4657285,26697,10096053
4072,2021-01-28,AR,392,403371,0,69,72120,0,0,2021-01-28,AR,2258,5251417,7392,4251652,9650,9503069
4073,2021-01-28,AR,392,403371,0,69,72120,0,0,2021-01-28,AR,32075,4891322,15768,3729686,47843,8621008
4074,2021-01-28,AR,392,403371,0,69,72120,0,0,2021-01-28,AR,8356,4245716,32809,3185900,41165,7431616
4075,2021-01-28,AR,392,403371,0,69,72120,0,0,2021-01-28,AR,6165,4021156,28098,2073032,34263,6094188
4076,2021-01-28,AR,392,403371,0,69,72120,0,0,2021-01-28,AR,35012,3564594,29981,956068,64993,4520662
4077,2021-01-28,AR,392,403371,0,69,72120,0,0,2021-01-28,AR,44899,2391636,7617,592145,52516,2983781
4078,2021-01-28,AR,392,403371,0,69,72120,0,0,2021-01-28,AR,17051,1343520,16537,397447,33588,1740967
4079,2021-01-28,AR,392,403371,0,69,72120,0,0,2021-01-28,AR,19686,1008117,3084,132258,22770,1140375
4080,2021-01-28,AR,392,403371,0,69,72120,0,0,2021-01-28,AR,3178,438735,4,96548,3182,535283
4081,2021-01-28,AR,392,403371,0,69,72120,0,0,2021-01-28,AR,593,133544,50,42961,643,176505
4082,2021-01-28,AR,392,403371,0,69,72120,0,0,2021-01-28,AR,229,39475,2062,9958,2291,49433
4083,2021-01-20,AR,374,412003,0,38,73301,0,0,2021-01-20,AR,6364,5397222,13505,4577161,19869,9974383
4084,2021-01-20,AR,374,412003,0,38,73301,0,0,2021-01-20,AR,5035,5201928,12079,4122988,17114,9324916
4085,2021-01-20,AR,374,412003,0,38,73301,0,0,2021-01-20,AR,43750,4626028,13364,3615568,57114,8241596
4086,2021-01-20,AR,374,412003,0,38,73301,0,0,2021-01-20,AR,6746,4175591,44364,2974683,51110,7150274
4087,2021-01-20,AR,374,412003,0,38,73301,0,0,2021-01-20,AR,17074,3939951,43573,1745564,60647,5685515
4088,2021-01-20,AR,374,412003,0,38,73301,0,0,2021-01-20,AR,33660,3284021,29674,826091,63334,4110112
4089,2021-01-20,AR,374,412003,0,38,73301,0,0,2021-01-20,AR,14799,2119241,646,543502,15445,2662743
4090,2021-01-20,AR,374,412003,0,38,73301,0,0,2021-01-20,AR,19878,1261502,5900,332533,25778,1594035
4091,2021-01-20,AR,374,412003,0,38,73301,0,0,2021-01-20,AR,15826,852227,2023,121847,17849,974074
4092,2021-01-20,AR,374,412003,0,38,73301,0,0,2021-01-20,AR,5444,370015,1769,88278,7213,458293
4093,2021-01-20,AR,374,412003,0,38,73301,0,0,2021-01-20,AR,4286,75619,196,38073,4482,113692
4094,2021-01-20,AR,374,412003,0,38,73301,0,0,2021-01-20,AR,849,35319,1936,2689,2785,38008
4095,2021-01-28,AR,263,414224,0,28,73569,0,0,2021-01-28,AR,9912,5438768,16785,4657285,26697,10096053
4096,2021-01-28,AR,263,414224,0,28,73569,0,0,2021-01-28,AR,2258,5251417,7392,4251652,9650,9503069
4097,2021-01-28,AR,263,414224,0,28,73569,0,0,2021-01-28,AR,32075,4891322,15768,3729686,47843,8621008
4098,2021-01-28,AR,263,414224,0,28,73569,0,0,2021-01-28,AR,8356,4245716,32809,3185900,41165,7431616
4099,2021-01-28,AR,263,414224,0,28,73569,0,0,2021-01-28,AR,6165,4021156,28098,2073032,34263,6094188
4100,2021-01-28,AR,263,414224,0,28,73569,0,0,2021-01-28,AR,35012,3564594,29981,956068,64993,4520662
4101,2021-01-28,AR,263,414224,0,28,73569,0,0,2021-01-28,AR,44899,2391636,7617,592145,52516,2983781
4102,2021-01-28,AR,263,414224,0,28,73569,0,0,2021-01-28,AR,17051,1343520,16537,397447,33588,1740967
4103,2021-01-28,AR,263,414224,0,28,73569,0,0,2021-01-28,AR,19686,1008117,3084,132258,22770,1140375
4104,2021-01-28,AR,263,414224,0,28,73569,0,0,2021-01-28,AR,3178,438735,4,96548,3182,535283
4105,2021-01-28,AR,263,414224,0,28,73569,0,0,2021-01-28,AR,593,133544,50,42961,643,176505
4106,2021-01-28,AR,263,414224,0,28,73569,0,0,2021-01-28,AR,229,39475,2062,9958,2291,49433
4107,2021-01-20,AR,312,419937,0,32,74246,0,0,2021-01-20,AR,6364,5397222,13505,4577161,19869,9974383
4108,2021-01-20,AR,312,419937,0,32,74246,0,0,2021-01-20,AR,5035,5201928,12079,4122988,17114,9324916
4109,2021-01-20,AR,312,419937,0,32,74246,0,0,2021-01-20,AR,43750,4626028,13364,3615568,57114,8241596
4110,2021-01-20,AR,312,419937,0,32,74246,0,0,2021-01-20,AR,6746,4175591,44364,2974683,51110,7150274
4111,2021-01-20,AR,312,419937,0,32,74246,0,0,2021-01-20,AR,17074,3939951,43573,1745564,60647,5685515
4112,2021-01-20,AR,312,419937,0,32,74246,0,0,2021-01-20,AR,33660,3284021,29674,826091,63334,4110112
4113,2021-01-20,AR,312,419937,0,32,74246,0,0,2021-01-20,AR,14799,2119241,646,543502,15445,2662743
4114,2021-01-20,AR,312,419937,0,32,74246,0,0,2021-01-20,AR,19878,1261502,5900,332533,25778,1594035
4115,2021-01-20,AR,312,419937,0,32,74246,0,0,2021-01-20,AR,15826,852227,2023,121847,17849,974074
4116,2021-01-20,AR,312,419937,0,32,74246,0,0,2021-01-20,AR,5444,370015,1769,88278,7213,458293
4117,2021-01-20,AR,312,419937,0,32,74246,0,0,2021-01-20,AR,4286,75619,196,38073,4482,113692
4118,2021-01-20,AR,312,419937,0,32,74246,0,0,2021-01-20,AR,849,35319,1936,2689,2785,38008
4119,2021-01-28,AR,275,421938,0,35,74494,0,0,2021-01-28,AR,9912,5438768,16785,4657285,26697,10096053
4120,2021-01-28,AR,275,421938,0,35,74494,0,0,2021-01-28,AR,2258,5251417,7392,4251652,9650,9503069
4121,2021-01-28,AR,275,421938,0,35,74494,0,0,2021-01-28,AR,32075,4891322,15768,3729686,47843,8621008
4122,2021-01-28,AR,275,421938,0,35,74494,0,0,2021-01-28,AR,8356,4245716,32809,3185900,41165,7431616
4123,2021-01-28,AR,275,421938,0,35,74494,0,0,2021-01-28,AR,6165,4021156,28098,2073032,34263,6094188
4124,2021-01-28,AR,275,421938,0,35,74494,0,0,2021-01-28,AR,35012,3564594,29981,956068,64993,4520662
4125,2021-01-28,AR,275,421938,0,35,74494,0,0,2021-01-28,AR,44899,2391636,7617,592145,52516,2983781
4126,2021-01-28,AR,275,421938,0,35,74494,0,0,2021-01-28,AR,17051,1343520,16537,397447,33588,1740967
4127,2021-01-28,AR,275,421938,0,35,74494,0,0,2021-01-28,AR,19686,1008117,3084,132258,22770,1140375
4128,2021-01-28,AR,275,421938,0,35,74494,0,0,2021-01-28,AR,3178,438735,4,96548,3182,535283
4129,2021-01-28,AR,275,421938,0,35,74494,0,0,2021-01-28,AR,593,133544,50,42961,643,176505
4130,2021-01-28,AR,275,421938,0,35,74494,0,0,2021-01-28,AR,229,39475,2062,9958,2291,49433
4131,2021-01-20,AR,156,427154,0,17,75118,0,0,2021-01-20,AR,6364,5397222,13505,4577161,19869,9974383
4132,2021-01-20,AR,156,427154,0,17,75118,0,0,2021-01-20,AR,5035,5201928,12079,4122988,17114,9324916
4133,2021-01-20,AR,156,427154,0,17,75118,0,0,2021-01-20,AR,43750,4626028,13364,3615568,57114,8241596
4134,2021-01-20,AR,156,427154,0,17,75118,0,0,2021-01-20,AR,6746,4175591,44364,2974683,51110,7150274
4135,2021-01-20,AR,156,427154,0,17,75118,0,0,2021-01-20,AR,17074,3939951,43573,1745564,60647,5685515
4136,2021-01-20,AR,156,427154,0,17,75118,0,0,2021-01-20,AR,33660,3284021,29674,826091,63334,4110112
4137,2021-01-20,AR,156,427154,0,17,75118,0,0,2021-01-20,AR,14799,2119241,646,543502,15445,2662743
4138,2021-01-20,AR,156,427154,0,17,75118,0,0,2021-01-20,AR,19878,1261502,5900,332533,25778,1594035
4139,2021-01-20,AR,156,427154,0,17,75118,0,0,2021-01-20,AR,15826,852227,2023,121847,17849,974074
4140,2021-01-20,AR,156,427154,0,17,75118,0,0,2021-01-20,AR,5444,370015,1769,88278,7213,458293
4141,2021-01-20,AR,156,427154,0,17,75118,0,0,2021-01-20,AR,4286,75619,196,38073,4482,113692
4142,2021-01-20,AR,156,427154,0,17,75118,0,0,2021-01-20,AR,849,35319,1936,2689,2785,38008
4143,2021-01-28,AR,189,428876,0,45,75383,0,0,2021-01-28,AR,9912,5438768,16785,4657285,26697,10096053
4144,2021-01-28,AR,189,428876,0,45,75383,0,0,2021-01-28,AR,2258,5251417,7392,4251652,9650,9503069
4145,2021-01-28,AR,189,428876,0,45,75383,0,0,2021-01-28,AR,32075,4891322,15768,3729686,47843,8621008
4146,2021-01-28,AR,189,428876,0,45,75383,0,0,2021-01-28,AR,8356,4245716,32809,3185900,41165,7431616
4147,2021-01-28,AR,189,428876,0,45,75383,0,0,2021-01-28,AR,6165,4021156,28098,2073032,34263,6094188
4148,2021-01-28,AR,189,428876,0,45,75383,0,0,2021-01-28,AR,35012,3564594,29981,956068,64993,4520662
4149,2021-01-28,AR,189,428876,0,45,75383,0,0,2021-01-28,AR,44899,2391636,7617,592145,52516,2983781
4150,2021-01-28,AR,189,428876,0,45,75383,0,0,2021-01-28,AR,17051,1343520,16537,397447,33588,1740967
4151,2021-01-28,AR,189,428876,0,45,75383,0,0,2021-01-28,AR,19686,1008117,3084,132258,22770,1140375
4152,2021-01-28,AR,189,428876,0,45,75383,0,0,2021-01-28,AR,3178,438735,4,96548,3182,535283
4153,2021-01-28,AR,189,428876,0,45,75383,0,0,2021-01-28,AR,593,133544,50,42961,643,176505
4154,2021-01-28,AR,189,428876,0,45,75383,0,0,2021-01-28,AR,229,39475,2062,9958,2291,49433
4155,2021-01-20,AR,279,433756,0,47,76082,0,0,2021-01-20,AR,6364,5397222,13505,4577161,19869,9974383
4156,2021-01-20,AR,279,433756,0,47,76082,0,0,2021-01-20,AR,5035,5201928,12079,4122988,17114,9324916
4157,2021-01-20,AR,279,433756,0,47,76082,0,0,2021-01-20,AR,43750,4626028,13364,3615568,57114,8241596
4158,2021-01-20,AR,279,433756,0,47,76082,0,0,2021-01-20,AR,6746,4175591,44364,2974683,51110,7150274
4159,2021-01-20,AR,279,433756,0,47,76082,0,0,2021-01-20,AR,17074,3939951,43573,1745564,60647,5685515
4160,2021-01-20,AR,279,433756,0,47,76082,0,0,2021-01-20,AR,33660,3284021,29674,826091,63334,4110112
4161,2021-01-20,AR,279,433756,0,47,76082,0,0,2021-01-20,AR,14799,2119241,646,543502,15445,2662743
4162,2021-01-20,AR,279,433756,0,47,76082,0,0,2021-01-20,AR,19878,1261502,5900,332533,25778,1594035
4163,2021-01-20,AR,279,433756,0,47,76082,0,0,2021-01-20,AR,15826,852227,2023,121847,17849,974074
4164,2021-01-20,AR,279,433756,0,47,76082,0,0,2021-01-20,AR,5444,370015,1769,88278,7213,458293
4165,2021-01-20,AR,279,433756,0,47,76082,0,0,2021-01-20,AR,4286,75619,196,38073,4482,113692
4166,2021-01-20,AR,279,433756,0,47,76082,0,0,2021-01-20,AR,849,35319,1936,2689,2785,38008
4167,2021-01-28,AR,396,435841,0,63,76406,0,0,2021-01-28,AR,9912,5438768,16785,4657285,26697,10096053
4168,2021-01-28,AR,396,435841,0,63,76406,0,0,2021-01-28,AR,2258,5251417,7392,4251652,9650,9503069
4169,2021-01-28,AR,396,435841,0,63,76406,0,0,2021-01-28,AR,32075,4891322,15768,3729686,47843,8621008
4170,2021-01-28,AR,396,435841,0,63,76406,0,0,2021-01-28,AR,8356,4245716,32809,3185900,41165,7431616
4171,2021-01-28,AR,396,435841,0,63,76406,0,0,2021-01-28,AR,6165,4021156,28098,2073032,34263,6094188
4172,2021-01-28,AR,396,435841,0,63,76406,0,0,2021-01-28,AR,35012,3564594,29981,956068,64993,4520662
4173,2021-01-28,AR,396,435841,0,63,76406,0,0,2021-01-28,AR,44899,2391636,7617,592145,52516,2983781
4174,2021-01-28,AR,396,435841,0,63,76406,0,0,2021-01-28,AR,17051,1343520,16537,397447,33588,1740967
4175,2021-01-28,AR,396,435841,0,63,76406,0,0,2021-01-28,AR,19686,1008117,3084,132258,22770,1140375
4176,2021-01-28,AR,396,435841,0,63,76406,0,0,2021-01-28,AR,3178,438735,4,96548,3182,535283
4177,2021-01-28,AR,396,435841,0,63,76406,0,0,2021-01-28,AR,593,133544,50,42961,643,176505
4178,2021-01-28,AR,396,435841,0,63,76406,0,0,2021-01-28,AR,229,39475,2062,9958,2291,49433
4179,2021-01-06,AR,680,236754,0,127,37903,0,0,2021-01-06,AR,9339,5317710,21131,4394774,30470,9712484
4180,2021-01-06,AR,680,236754,0,127,37903,0,0,2021-01-06,AR,8601,5065760,11162,3856507,19763,8922267
4181,2021-01-06,AR,680,236754,0,127,37903,0,0,2021-01-06,AR,8758,4311372,26355,3401117,35113,7712489
4182,2021-01-06,AR,680,236754,0,127,37903,0,0,2021-01-06,AR,7156,4097374,55096,2469262,62252,6566636
4183,2021-01-06,AR,680,236754,0,127,37903,0,0,2021-01-06,AR,19199,3777897,41639,1227229,60838,5005126
4184,2021-01-06,AR,680,236754,0,127,37903,0,0,2021-01-06,AR,37848,2711098,19877,692788,57725,3403886
4185,2021-01-06,AR,680,236754,0,127,37903,0,0,2021-01-06,AR,28827,1660492,1695,447131,30522,2107623
4186,2021-01-06,AR,680,236754,0,127,37903,0,0,2021-01-06,AR,20057,1117187,9225,187382,29282,1304569
4187,2021-01-06,AR,680,236754,0,127,37903,0,0,2021-01-06,AR,25502,592945,1219,101854,26721,694799
4188,2021-01-06,AR,680,236754,0,127,37903,0,0,2021-01-06,AR,7162,196286,546,50418,7708,246704
4189,2021-01-06,AR,680,236754,0,127,37903,0,0,2021-01-06,AR,458,45952,1095,27928,1553,73880
4190,2021-01-06,AR,680,236754,0,127,37903,0,0,2021-01-06,AR,1451,10907,0,1,1451,10908
4191,2021-01-06,AR,429,253619,0,116,41233,0,0,2021-01-06,AR,9339,5317710,21131,4394774,30470,9712484
4192,2021-01-06,AR,429,253619,0,116,41233,0,0,2021-01-06,AR,8601,5065760,11162,3856507,19763,8922267
4193,2021-01-06,AR,429,253619,0,116,41233,0,0,2021-01-06,AR,8758,4311372,26355,3401117,35113,7712489
4194,2021-01-06,AR,429,253619,0,116,41233,0,0,2021-01-06,AR,7156,4097374,55096,2469262,62252,6566636
4195,2021-01-06,AR,429,253619,0,116,41233,0,0,2021-01-06,AR,19199,3777897,41639,1227229,60838,5005126
4196,2021-01-06,AR,429,253619,0,116,41233,0,0,2021-01-06,AR,37848,2711098,19877,692788,57725,3403886
4197,2021-01-06,AR,429,253619,0,116,41233,0,0,2021-01-06,AR,28827,1660492,1695,447131,30522,2107623
4198,2021-01-06,AR,429,253619,0,116,41233,0,0,2021-01-06,AR,20057,1117187,9225,187382,29282,1304569
4199,2021-01-06,AR,429,253619,0,116,41233,0,0,2021-01-06,AR,25502,592945,1219,101854,26721,694799
4200,2021-01-06,AR,429,253619,0,116,41233,0,0,2021-01-06,AR,7162,196286,546,50418,7708,246704
4201,2021-01-06,AR,429,253619,0,116,41233,0,0,2021-01-06,AR,458,45952,1095,27928,1553,73880
4202,2021-01-06,AR,429,253619,0,116,41233,0,0,2021-01-06,AR,1451,10907,0,1,1451,10908
4203,2021-01-06,AR,353,266011,0,66,43534,0,0,2021-01-06,AR,9339,5317710,21131,4394774,30470,9712484
4204,2021-01-06,AR,353,266011,0,66,43534,0,0,2021-01-06,AR,8601,5065760,11162,3856507,19763,8922267
4205,2021-01-06,AR,353,266011,0,66,43534,0,0,2021-01-06,AR,8758,4311372,26355,3401117,35113,7712489
4206,2021-01-06,AR,353,266011,0,66,43534,0,0,2021-01-06,AR,7156,4097374,55096,2469262,62252,6566636
4207,2021-01-06,AR,353,266011,0,66,43534,0,0,2021-01-06,AR,19199,3777897,41639,1227229,60838,5005126
4208,2021-01-06,AR,353,266011,0,66,43534,0,0,2021-01-06,AR,37848,2711098,19877,692788,57725,3403886
4209,2021-01-06,AR,353,266011,0,66,43534,0,0,2021-01-06,AR,28827,1660492,1695,447131,30522,2107623
4210,2021-01-06,AR,353,266011,0,66,43534,0,0,2021-01-06,AR,20057,1117187,9225,187382,29282,1304569
4211,2021-01-06,AR,353,266011,0,66,43534,0,0,2021-01-06,AR,25502,592945,1219,101854,26721,694799
4212,2021-01-06,AR,353,266011,0,66,43534,0,0,2021-01-06,AR,7162,196286,546,50418,7708,246704
4213,2021-01-06,AR,353,266011,0,66,43534,0,0,2021-01-06,AR,458,45952,1095,27928,1553,73880
4214,2021-01-06,AR,353,266011,0,66,43534,0,0,2021-01-06,AR,1451,10907,0,1,1451,10908
4215,2021-01-06,AR,804,282223,0,154,46852,0,0,2021-01-06,AR,9339,5317710,21131,4394774,30470,9712484
4216,2021-01-06,AR,804,282223,0,154,46852,0,0,2021-01-06,AR,8601,5065760,11162,3856507,19763,8922267
4217,2021-01-06,AR,804,282223,0,154,46852,0,0,2021-01-06,AR,8758,4311372,26355,3401117,35113,7712489
4218,2021-01-06,AR,804,282223,0,154,46852,0,0,2021-01-06,AR,7156,4097374,55096,2469262,62252,6566636
4219,2021-01-06,AR,804,282223,0,154,46852,0,0,2021-01-06,AR,19199,3777897,41639,1227229,60838,5005126
4220,2021-01-06,AR,804,282223,0,154,46852,0,0,2021-01-06,AR,37848,2711098,19877,692788,57725,3403886
4221,2021-01-06,AR,804,282223,0,154,46852,0,0,2021-01-06,AR,28827,1660492,1695,447131,30522,2107623
4222,2021-01-06,AR,804,282223,0,154,46852,0,0,2021-01-06,AR,20057,1117187,9225,187382,29282,1304569
4223,2021-01-06,AR,804,282223,0,154,46852,0,0,2021-01-06,AR,25502,592945,1219,101854,26721,694799
4224,2021-01-06,AR,804,282223,0,154,46852,0,0,2021-01-06,AR,7162,196286,546,50418,7708,246704
4225,2021-01-06,AR,804,282223,0,154,46852,0,0,2021-01-06,AR,458,45952,1095,27928,1553,73880
4226,2021-01-06,AR,804,282223,0,154,46852,0,0,2021-01-06,AR,1451,10907,0,1,1451,10908
4227,2021-01-06,AR,902,309072,0,215,52573,0,0,2021-01-06,AR,9339,5317710,21131,4394774,30470,9712484
4228,2021-01-06,AR,902,309072,0,215,52573,0,0,2021-01-06,AR,8601,5065760,11162,3856507,19763,8922267
4229,2021-01-06,AR,902,309072,0,215,52573,0,0,2021-01-06,AR,8758,4311372,26355,3401117,35113,7712489
4230,2021-01-06,AR,902,309072,0,215,52573,0,0,2021-01-06,AR,7156,4097374,55096,2469262,62252,6566636
4231,2021-01-06,AR,902,309072,0,215,52573,0,0,2021-01-06,AR,19199,3777897,41639,1227229,60838,5005126
4232,2021-01-06,AR,902,309072,0,215,52573,0,0,2021-01-06,AR,37848,2711098,19877,692788,57725,3403886
4233,2021-01-06,AR,902,309072,0,215,52573,0,0,2021-01-06,AR,28827,1660492,1695,447131,30522,2107623
4234,2021-01-06,AR,902,309072,0,215,52573,0,0,2021-01-06,AR,20057,1117187,9225,187382,29282,1304569
4235,2021-01-06,AR,902,309072,0,215,52573,0,0,2021-01-06,AR,25502,592945,1219,101854,26721,694799
4236,2021-01-06,AR,902,309072,0,215,52573,0,0,2021-01-06,AR,7162,196286,546,50418,7708,246704
4237,2021-01-06,AR,902,309072,0,215,52573,0,0,2021-01-06,AR,458,45952,1095,27928,1553,73880
4238,2021-01-06,AR,902,309072,0,215,52573,0,0,2021-01-06,AR,1451,10907,0,1,1451,10908
4239,2021-01-06,AR,968,343125,0,233,60144,0,0,2021-01-06,AR,9339,5317710,21131,4394774,30470,9712484
4240,2021-01-06,AR,968,343125,0,233,60144,0,0,2021-01-06,AR,8601,5065760,11162,3856507,19763,8922267
4241,2021-01-06,AR,968,343125,0,233,60144,0,0,2021-01-06,AR,8758,4311372,26355,3401117,35113,7712489
4242,2021-01-06,AR,968,343125,0,233,60144,0,0,2021-01-06,AR,7156,4097374,55096,2469262,62252,6566636
4243,2021-01-06,AR,968,343125,0,233,60144,0,0,2021-01-06,AR,19199,3777897,41639,1227229,60838,5005126
4244,2021-01-06,AR,968,343125,0,233,60144,0,0,2021-01-06,AR,37848,2711098,19877,692788,57725,3403886
4245,2021-01-06,AR,968,343125,0,233,60144,0,0,2021-01-06,AR,28827,1660492,1695,447131,30522,2107623
4246,2021-01-06,AR,968,343125,0,233,60144,0,0,2021-01-06,AR,20057,1117187,9225,187382,29282,1304569
4247,2021-01-06,AR,968,343125,0,233,60144,0,0,2021-01-06,AR,25502,592945,1219,101854,26721,694799
4248,2021-01-06,AR,968,343125,0,233,60144,0,0,2021-01-06,AR,7162,196286,546,50418,7708,246704
4249,2021-01-06,AR,968,343125,0,233,60144,0,0,2021-01-06,AR,458,45952,1095,27928,1553,73880
4250,2021-01-06,AR,968,343125,0,233,60144,0,0,2021-01-06,AR,1451,10907,0,1,1451,10908
4251,2021-01-06,AR,918,370535,0,186,66041,0,0,2021-01-06,AR,9339,5317710,21131,4394774,30470,9712484
4252,2021-01-06,AR,918,370535,0,186,66041,0,0,2021-01-06,AR,8601,5065760,11162,3856507,19763,8922267
4253,2021-01-06,AR,918,370535,0,186,66041,0,0,2021-01-06,AR,8758,4311372,26355,3401117,35113,7712489
4254,2021-01-06,AR,918,370535,0,186,66041,0,0,2021-01-06,AR,7156,4097374,55096,2469262,62252,6566636
4255,2021-01-06,AR,918,370535,0,186,66041,0,0,2021-01-06,AR,19199,3777897,41639,1227229,60838,5005126
4256,2021-01-06,AR,918,370535,0,186,66041,0,0,2021-01-06,AR,37848,2711098,19877,692788,57725,3403886
4257,2021-01-06,AR,918,370535,0,186,66041,0,0,2021-01-06,AR,28827,1660492,1695,447131,30522,2107623
4258,2021-01-06,AR,918,370535,0,186,66041,0,0,2021-01-06,AR,20057,1117187,9225,187382,29282,1304569
4259,2021-01-06,AR,918,370535,0,186,66041,0,0,2021-01-06,AR,25502,592945,1219,101854,26721,694799
4260,2021-01-06,AR,918,370535,0,186,66041,0,0,2021-01-06,AR,7162,196286,546,50418,7708,246704
4261,2021-01-06,AR,918,370535,0,186,66041,0,0,2021-01-06,AR,458,45952,1095,27928,1553,73880
4262,2021-01-06,AR,918,370535,0,186,66041,0,0,2021-01-06,AR,1451,10907,0,1,1451,10908
4263,2021-01-06,AR,627,392166,0,125,70173,0,0,2021-01-06,AR,9339,5317710,21131,4394774,30470,9712484
4264,2021-01-06,AR,627,392166,0,125,70173,0,0,2021-01-06,AR,8601,5065760,11162,3856507,19763,8922267
4265,2021-01-06,AR,627,392166,0,125,70173,0,0,2021-01-06,AR,8758,4311372,26355,3401117,35113,7712489
4266,2021-01-06,AR,627,392166,0,125,70173,0,0,2021-01-06,AR,7156,4097374,55096,2469262,62252,6566636
4267,2021-01-06,AR,627,392166,0,125,70173,0,0,2021-01-06,AR,19199,3777897,41639,1227229,60838,5005126
4268,2021-01-06,AR,627,392166,0,125,70173,0,0,2021-01-06,AR,37848,2711098,19877,692788,57725,3403886
4269,2021-01-06,AR,627,392166,0,125,70173,0,0,2021-01-06,AR,28827,1660492,1695,447131,30522,2107623
4270,2021-01-06,AR,627,392166,0,125,70173,0,0,2021-01-06,AR,20057,1117187,9225,187382,29282,1304569
4271,2021-01-06,AR,627,392166,0,125,70173,0,0,2021-01-06,AR,25502,592945,1219,101854,26721,694799
4272,2021-01-06,AR,627,392166,0,125,70173,0,0,2021-01-06,AR,7162,196286,546,50418,7708,246704
4273,2021-01-06,AR,627,392166,0,125,70173,0,0,2021-01-06,AR,458,45952,1095,27928,1553,73880
4274,2021-01-06,AR,627,392166,0,125,70173,0,0,2021-01-06,AR,1451,10907,0,1,1451,10908
4275,2021-01-06,AR,443,407153,0,63,72663,0,0,2021-01-06,AR,9339,5317710,21131,4394774,30470,9712484
4276,2021-01-06,AR,443,407153,0,63,72663,0,0,2021-01-06,AR,8601,5065760,11162,3856507,19763,8922267
4277,2021-01-06,AR,443,407153,0,63,72663,0,0,2021-01-06,AR,8758,4311372,26355,3401117,35113,7712489
4278,2021-01-06,AR,443,407153,0,63,72663,0,0,2021-01-06,AR,7156,4097374,55096,2469262,62252,6566636
4279,2021-01-06,AR,443,407153,0,63,72663,0,0,2021-01-06,AR,19199,3777897,41639,1227229,60838,5005126
4280,2021-01-06,AR,443,407153,0,63,72663,0,0,2021-01-06,AR,37848,2711098,19877,692788,57725,3403886
4281,2021-01-06,AR,443,407153,0,63,72663,0,0,2021-01-06,AR,28827,1660492,1695,447131,30522,2107623
4282,2021-01-06,AR,443,407153,0,63,72663,0,0,2021-01-06,AR,20057,1117187,9225,187382,29282,1304569
4283,2021-01-06,AR,443,407153,0,63,72663,0,0,2021-01-06,AR,25502,592945,1219,101854,26721,694799
4284,2021-01-06,AR,443,407153,0,63,72663,0,0,2021-01-06,AR,7162,196286,546,50418,7708,246704
4285,2021-01-06,AR,443,407153,0,63,72663,0,0,2021-01-06,AR,458,45952,1095,27928,1553,73880
4286,2021-01-06,AR,443,407153,0,63,72663,0,0,2021-01-06,AR,1451,10907,0,1,1451,10908
4287,2021-01-06,AR,319,416425,0,36,73837,0,0,2021-01-06,AR,9339,5317710,21131,4394774,30470,9712484
4288,2021-01-06,AR,319,416425,0,36,73837,0,0,2021-01-06,AR,8601,5065760,11162,3856507,19763,8922267
4289,2021-01-06,AR,319,416425,0,36,73837,0,0,2021-01-06,AR,8758,4311372,26355,3401117,35113,7712489
4290,2021-01-06,AR,319,416425,0,36,73837,0,0,2021-01-06,AR,7156,4097374,55096,2469262,62252,6566636
4291,2021-01-06,AR,319,416425,0,36,73837,0,0,2021-01-06,AR,19199,3777897,41639,1227229,60838,5005126
4292,2021-01-06,AR,319,416425,0,36,73837,0,0,2021-01-06,AR,37848,2711098,19877,692788,57725,3403886
4293,2021-01-06,AR,319,416425,0,36,73837,0,0,2021-01-06,AR,28827,1660492,1695,447131,30522,2107623
4294,2021-01-06,AR,319,416425,0,36,73837,0,0,2021-01-06,AR,20057,1117187,9225,187382,29282,1304569
4295,2021-01-06,AR,319,416425,0,36,73837,0,0,2021-01-06,AR,25502,592945,1219,101854,26721,694799
4296,2021-01-06,AR,319,416425,0,36,73837,0,0,2021-01-06,AR,7162,196286,546,50418,7708,246704
4297,2021-01-06,AR,319,416425,0,36,73837,0,0,2021-01-06,AR,458,45952,1095,27928,1553,73880
4298,2021-01-06,AR,319,416425,0,36,73837,0,0,2021-01-06,AR,1451,10907,0,1,1451,10908
4299,2021-01-06,AR,144,424019,0,15,74733,0,0,2021-01-06,AR,9339,5317710,21131,4394774,30470,9712484
4300,2021-01-06,AR,144,424019,0,15,74733,0,0,2021-01-06,AR,8601,5065760,11162,3856507,19763,8922267
4301,2021-01-06,AR,144,424019,0,15,74733,0,0,2021-01-06,AR,8758,4311372,26355,3401117,35113,7712489
4302,2021-01-06,AR,144,424019,0,15,74733,0,0,2021-01-06,AR,7156,4097374,55096,2469262,62252,6566636
4303,2021-01-06,AR,144,424019,0,15,74733,0,0,2021-01-06,AR,19199,3777897,41639,1227229,60838,5005126
4304,2021-01-06,AR,144,424019,0,15,74733,0,0,2021-01-06,AR,37848,2711098,19877,692788,57725,3403886
4305,2021-01-06,AR,144,424019,0,15,74733,0,0,2021-01-06,AR,28827,1660492,1695,447131,30522,2107623
4306,2021-01-06,AR,144,424019,0,15,74733,0,0,2021-01-06,AR,20057,1117187,9225,187382,29282,1304569
4307,2021-01-06,AR,144,424019,0,15,74733,0,0,2021-01-06,AR,25502,592945,1219,101854,26721,694799
4308,2021-01-06,AR,144,424019,0,15,74733,0,0,2021-01-06,AR,7162,196286,546,50418,7708,246704
4309,2021-01-06,AR,144,424019,0,15,74733,0,0,2021-01-06,AR,458,45952,1095,27928,1553,73880
4310,2021-01-06,AR,144,424019,0,15,74733,0,0,2021-01-06,AR,1451,10907,0,1,1451,10908
4311,2021-01-06,AR,278,430694,0,36,75614,0,0,2021-01-06,AR,9339,5317710,21131,4394774,30470,9712484
4312,2021-01-06,AR,278,430694,0,36,75614,0,0,2021-01-06,AR,8601,5065760,11162,3856507,19763,8922267
4313,2021-01-06,AR,278,430694,0,36,75614,0,0,2021-01-06,AR,8758,4311372,26355,3401117,35113,7712489
4314,2021-01-06,AR,278,430694,0,36,75614,0,0,2021-01-06,AR,7156,4097374,55096,2469262,62252,6566636
4315,2021-01-06,AR,278,430694,0,36,75614,0,0,2021-01-06,AR,19199,3777897,41639,1227229,60838,5005126
4316,2021-01-06,AR,278,430694,0,36,75614,0,0,2021-01-06,AR,37848,2711098,19877,692788,57725,3403886
4317,2021-01-06,AR,278,430694,0,36,75614,0,0,2021-01-06,AR,28827,1660492,1695,447131,30522,2107623
4318,2021-01-06,AR,278,430694,0,36,75614,0,0,2021-01-06,AR,20057,1117187,9225,187382,29282,1304569
4319,2021-01-06,AR,278,430694,0,36,75614,0,0,2021-01-06,AR,25502,592945,1219,101854,26721,694799
4320,2021-01-06,AR,278,430694,0,36,75614,0,0,2021-01-06,AR,7162,196286,546,50418,7708,246704
4321,2021-01-06,AR,278,430694,0,36,75614,0,0,2021-01-06,AR,458,45952,1095,27928,1553,73880
4322,2021-01-06,AR,278,430694,0,36,75614,0,0,2021-01-06,AR,1451,10907,0,1,1451,10908
